猫=cat
熊=bear
熊猫=panda
狗=dog
兔子=rabbit
老鼠=mouse
大鼠=rat
老虎=tiger
狮子=lion
马=horse
鸟=bird
鸡=chicken
火鸡=turkey
鹦鹉=parrot
鸽子=pigeon
鸵鸟=ostrich
企鹅=penguin
狐狸=fox
松鼠=squirrel
鹿=deer
牛=cow
犀牛=rhino
羊=sheep
山羊=goat
河马=hippopotamus
大象=elephant
猴子=monkey
鱼=fish
海豚=dolphin
鲸=whale
章鱼=octopus
鱿鱼=squid
螃蟹=crab
