冥想=contemplation
打坐=meditation
焦点=focus
气息=breath(noun)
呼吸=to breathe(verb)
和平=peace
冷静=calmness
意识=consciousness
金刚经=diamond sutra
佛经=sutra
佛教=Buddhism
戒条=dharma
瑜伽=yoga
禅=Zen
达赖喇嘛=Dalai Lama
仁波切=rinpoche
西藏=Tibet
转世=reincarnation
因果报应=karma
大日如来=Vairocana
舍利子=Sariputta
辩才天=Sarasvati
地藏王菩萨=Ksitigarbha
观世音菩萨=Avalokitesvara
释迦牟尼=Shakyamuni
药师如来=Medicine Buddha
阿弥陀佛=Amitabha
罗汉=Arhat
卧佛=Reclining Buddha
涅槃=nirvana
佛性=buddha nature
般若波罗蜜多心经=Heart Sutra
密宗=Vajrayana
东密=Japanese Esotericism
真言=Shingon
菩提=Bodhi
大般涅盘经=Nirvana Sutra
八正道=Eight-fold path
四圣谛=Four Noble Truths
