頭=head
身體=body
脖子=neck
肩膀=shoulder
手臂=arm
手=hand
胸=chest
肚子=stomach
背=back
腿=leg
腳=foot
手指=finger
膝蓋=knee
頭髮=hair
手肘=elbow
臉=face
鼻子=nose
耳朵=ear
額頭=forehead
眼睛=eyes
腳趾=toe
睫毛=eyelashes
牙齒=tooth
眉毛=eyebrow
臉頰=cheek
嘴巴=mouth
奶子=breast
疼=to hurt
癢=to itch
酸=to be sore
放屁=fart
出汗=to sweat
呼吸=to breathe
口渴=thirsty
餓了=hungry
頭暈=dizzy
喝醉=to be drunk
上廁所=to go to the toilet
小便=piss
便便=to poop
腹瀉=diarrhoea
嘔吐=to vomit
想吐=to feel sick
