白领=white collar
办事=to handle affairs
包销=to have exclusive selling rights
保养=to maintain
包销商=exclusive agent
保证=guarantee
保准=to assure
报价=price report
便条=informal note
报盘=offer, quotation
备货=stock order; to make to stock
标准=standard
便于=easy to
比例=proportion
部分=part
部门=department
财务=financial affairs
仓库=depot
策划=to design; planning
车间=workshop
成立=to establish
成分=composition
成品=finished product
承诺=promise
抽查=sample inspection
筹划=to plan and prepare
处理=to handle (process)
出席=to attend
传统=tradition
促销=promotion
存档=to save a file
磋商=to consult
打开=to open
打入=to infiltrate
打印=to print
大约=approximately
大概=approximately
大会=general assembly
代表=representative
到达=to reach
抵达=to arrive
耽误=to delay
地点=place
调查=investigation
电子邮件=email
订单=order form
订购=to order
订货量=volume of order
定价=fixed price
定位=position
董事会=board (of directors)
独家代理=sole agency
短信=text message
对策=countermeasure
发布会=conference
发挥=to bring into play
发送=to send
发言=statement
发展=development
繁忙=busy
费用=cost
方式=way of life
分公司=subsidiary company
服务=to serve / service
付帐=to pay
负责=to be in charge of
符合=in keeping with
付=to pay
否则=if not
丰富=abundant
分析=to analyze
分批=to divide into batches
复印件=to photocopy
公事=official business
公开=to make public
功能=function
工厂=factory
更加=even more
高见=your opinion
感兴趣=to feel interested
赶快=hurriedly
改变=to change
富裕=to prosper
副=vice (as in "vice-president")
购买力=purchasing power
规范=norm
规模=scale
归档=to file
规则=rule
规定=provision
归档=to place on file
惯例=conventional
国际=international
过程=process
手续=formalities
含有=to contain
合格=qualified
合理=rational
和解=to settle (a dispute out of court)
怀疑=to doubt
汇报=to report
汇款=remittance
会场=meeting place
会面=to meet
会谈=talks
会议=meeting
货款=payment for goods
货物=goods
检测=to detect; to test; detection
加工=to process
季节性=seasonal
季度=quarter (of a year)
检查=inspection
见效=to see effect
交货=to deliver goods
交易=exchange
阶层=hierarchy
金额=sum of money
进口=to import
进行=to advance
经销=to resell
具体=concrete
开证行=bank issuing a letter of credit
竞争=competition
具有=to have
看好=promising, bullish
恳请=obtest
跨国=transnational
款待=to entertain
扩大=to expand
离不开=to require
礼堂=assembly hall
例会=regular meeting
留念=to keep as a souvenir
留言=to leave ones comments
落实=practical
免费=free (of charge)
模式=mode
培训=to cultivate; to train
赔偿=to compensate
配方=dispensing
蓬勃=vigorous, flourishing
批量=batch
品牌=brand
品质=quality
评价=to evaluate
破费=to spend money
企业=business
签约=to sign a contract
前景=outlook
抢手=quickly to sell
请柬=invitation card
清理=clear
侵犯=to infringe on
请帖=written invitation
取得=to get
取消=to cancel
让步=to concede
人事=human affairs
认知度=popularity
荣幸=honored
入席=to take a seat (at a dinner table)
事务=(political, economic etc) affairs
收下=to accept
收入=income
适中=moderate
失误=lapse
省得=so as to avoid
生产线=assembly line
设施=facilities
商务=business affairs
商标=trademark
手段=method
柔和=gentle
私人=private citizen
数量=amount
损失=loss
调整=adjustment
提前=to shift to an earlier date
提高=to raise
特点=characteristic (feature)
谈判=to negotiate
天然=natural
条件=condition
听取=to hear news of
停止=to stop
通融=to make an exception
同类=similar
投放=to put in circulation
推出=to release
推广=to popularize
托收=encashment
万无一失=almost impossible to lose
旺季=busy season
问卷=questionnaire
吸引力=attractiveness
系列=series
下旬=last third of the month
效果=result
销毁=to destroy (by melting or burning)
消费者=consumer
消费=to consume
详细=detailed
箱=case
相当=to a certain extent
先进=advanced (technology)
显著=outstanding
笑纳=to kindly accept
信函=correspondence
信用证=letter of credit
询价=price inquiry
延误=delay
研发=research and development
邀请函=invitation letter
业绩=outstanding achievement
意下=opinion, in the mind
一致=unanimous
一向=all along
一贯=consistent
业务=business service
应有=should have
盈利=profit
营销=marketing
佣金=commission
优势=superiority
优良=excellent
优惠=advantage
优秀=outstanding
有利于=to be beneficial to
有限=limited
有效=effectiveness
有效期=effective period
娱乐=entertainment
预算会=budget meeting
圆满=satisfactory
约见=to make an appointment
造性=shape; modeling
占有率=rate of occupancy
招标=to open bidding
招待=reception
招待会=press conference
招聘=recruitment
找回=to look for
召集=to convene
召见=to summon
制定=to draw up
职员=clerk
知名=famous
支付=payment, to pay
争来争取=to keep arguing
争=to compete
针对=in connection with
召开=to convene
质量=quality
中老年=middle and old age
中青年=middle-age
中旬=middle third of a month
上旬=the first 10 days of a month
祝酒辞=toast
主管=in charge
主持=to preside over
装运=to load
资信=capital and credit
自营=self-support
总结会=summary meeting
作用=to affect
座谈会=discussion meeting
