衣服=clothes
和服=kimono
韩服=hanbok
纱丽=sari
汉服=Han Chinese clothing
旗袍=cheongsam
西装=suit
裙子=skirt
连衣裙=dress
上衣=top
裤子=pants
鞋子=shoes
穿=to wear (clothes)
戴=to wear (accessories)
帽子=hat
眼镜=glasses
太阳镜=sunglasses
袜子=socks
牛仔裤=jeans
短裤=shorts
短裙=short skirt
长裙=long skirt
长裤=long pants
迷你裙=mini skirt
衬衫=collared shirt
体恤衫=t-shirt
毛衣=sweater
针织衫=cardigan
外套=overcoat
夹克衫=jacket
靴子=boots
皮鞋=leather shoes
拖鞋=slippers
人字拖=flip flops
长靴=tall boots
短靴=short boots
睡衣=pajamas
校服=school uniform
皮衣=leather clothes
内裤=underwear
领带=tie
皮带=belt
