意识形态=ideology
结盟=form an alliance, ally
争夺=fight with sb. over sth.
爆发=(of a volcano) erupt, break out
预计=estimate, or predict in advance
饮用水=drinkable water
离家出走=run away, flee (from one's home)
寻找=seek, search
水源=source of water
难民=refugee
安定=stable, settled
因素=factor
缺=lack of
矛盾=contradiction, conflict
酸雨=acid rain
二氧化硫=sulphur dioxide
纠纷=dispute, conflict
本身=oneself, in oneself
限于=be confined to, be limited to
荒漠化=Desertization
无关=have nothing to do with
角落=corner, remote place
生态=ecology
退化=degrading, deterioration
衰退=fail, decline
动荡=experience unrest, turmoil (social or political)
强权=super power
掠夺=plunder, rob, loot
任凭=allow or let sb. do as he pleases
移民=migrate, emigrate
自身=self, oneself
内政=internal or domestic affairs
环境=environment
狼=wolf
脊椎=vertebra
熊=bear
虎=tiger
鹿=deer
大型=large, large-scale
成群结队=as a group, in crowds
变迁=change，shift of phases
灭绝=become extinct, die out
兔=rabbit
适应=adapt to
顽强=hard to defeat
瘆=frighten, scare
嚎=howl, bawl; wail
当地=locality, place mentioned
黄昏=dusk, evening
记事=(of a child) begin to remember things
无影无踪=leaving without trace
郁郁葱葱=green and luxuriant
露=reveal, show, show
方圆=vicinity, neighborhood
水泥=cement
烟囱=chimney, funnel, stovepipe
粉尘=powder, dust
飘落=drift and fall slowly
含量=content
增高=increase
干枯=dried out
之类=and/or the like, and so on
耽误=delay, hold up
忙忙碌碌=busy
经商=do business
恶果=bad consequence
有害=be harmful
收效=yield results, produce effects
挽回=to retrieve, to redeem
以色列=Israel
西欧=Western Europe
中东=Middle East
周口店=Zhoukoudian
一系列=a series of
膨胀=expansion, swelling, inflation
过度=excessive
大气=atmosphere
污染=pollution
温室效应=greenhouse effect
臭氧层=ozone layer
水质=water quality
参议员=senator
说服=persuade, convince
提议=propose, suggest, move
讲习会=lecture
法学院=law school
大规模=large-scale, wide scale
次=second, next
声势浩大=great in strength and impetus
团体=group, organization, team
举=hold up
模型=model, mold, pattern
图表=chart, diagram, schematics
游行=parade, march, demonstration
集会=assembly, rally, gathering
演讲=lecture, speech
促使=impel, urge, spur
趋于=tend to, incline to
国际化=internationalization
整体=whole, entirety
清醒=wide awake, clear-headed
下降=descend, decline
威胁=threaten, endanger, menace
世界=world
逢=meet, encounter
化学品=chemical products
涂=spread on, apply
抹=put on, smear, wipe
药水=liquid medicine
搁=put
肆无忌惮=unbridled
生存=survive, live
有心=having a mind to do something
无意=unintentional, accidental
随手=conveniently
抛=throw, toss
顺手=conveniently, in passing
不时=frequently, often
人造=man-made, artificial
溪=small stream, brook
肉眼=naked eyes
人体=human body
躲=avoid, hide
隐形=invisible
定时炸弹=time bomb
内分泌=internal secretion
失调=lose balance
生育力=ability to give birth
害怕=be afraid of, be scared of
肿瘤=tumor, cancer
惊呼=cry out in alarm
保健品=health care products
噪音=noise
耸人听闻=deliberately exaggerate so as to create a sensation
溪流=stream
药品=medicines and chemical products
洗涤剂=cleanser
添加剂=additives
辅助剂=auxiliary products
咖啡因=caffeine
避孕药=birth control pills
止痛药=pain killer
退烧药=fever reducing pills, antipyretic
防蚊剂=mosquito repellent
香水=perfume, cologne
烟碱=nicotine
忧心=worry
逃过=escape
估量=estimate, appraise
化合物=chemical compounds
货架=stock shelf
医药箱=first aid box
储藏室=storage room
日复一日=day after day
年复一年=year after year
排水沟=drainage
下水道=sewer
浓度=density, thickness
因而=therefore, as a result
抗菌素=antibiotic
清洁剂=cleanser
兽=beast, animal
细菌=germ, bacteria
抗药性=resistance to the action of a drug
激素=hormone
畸变=undergo abnormal transformation
生物=living being
致癌=cause cancer
慎用=use with caution
设法=try, manage, strive
化解=resolve, eliminate
妥善=appropriate, proper
条例=regulations, rules
清澈=crystal-clear
民主党=the Democratic Party
世界地球日=World Earth Day
撤离=withdraw from, evacuate
官邸=official residence
调查=Investigation, check,survey
解散=disband an organization, dismiss
凌晨=before dawn, early in the morning
拒绝=rejec (a request, opinion, or offer),
难民=refugee
涉嫌=be suspected of being involved, be a suspect (in a crime)
刺杀=assassinate, kill sb.
走私=smuggling
监狱=prison, jail
部署=deploy
撤退=retreat, pullout, withdraw
目击者=eyewitness, witness
外围=periphery, peripheral area
逮捕=arrest, capture, make an arrest
怀疑=suspect
随即=soon after that, immediately
炸弹=bomb
报复=Retaliate
关押=lock up, imprison, put under detention
深夜=deep in the night, late at night
教堂=church, temple, cathedral
交火=exchange fire
起火=be on fire, catch fire
受伤=sustain an injury, be injured
遗憾=regret, pity
真相=real situation, facts, truth
大洋=ocean
彼岸=the other side
振奋=inspire, stimulate, excite
决议=resolution, decision
历史性=being of historic significance
出席=attend, be present
途=route, way
何时=when
连珠炮=continuous firing, drumfire
从容不迫=take it leisurely, calm and unhurried, self-possessed
似=be like, resemble
侃侃而谈=talk with ease and confidence
老话=old saying, adage
飘飘欲仙=feel that one is flying up towards heaven like an immortal
自由自在=happy-go-lucky, carefree
何=what
成语=idiom, proverb, set phrase
水到渠成=when the water comes, a channel is formed -- when conditions are ripe, success is achieved
泱泱大国=a great and proud country
排斥=reject, exclude, repel
穷追不舍=hotly pursue and not leave alone
轿车=car
好家伙=Wow! My God!
头盔=(steel) helmet
寒风=cold wind
刊登=publish in a newspaper or magazine
附=add, attach
大使=ambassador
大厨=master chef
师傅=master
气度不凡=having extraordinarily dignified and impressive bearing and manner
哈哈大笑=laugh loudly
慧眼独具=having a unique insight
拍=shoot, take (pictures)
讲坛=(speaker's) platform, rostrum
讲演=speech
妙语连珠=a stream of witticism
分析=analysis
入情入理=fair and reasonable
淋漓尽致=incisive and vivid
赢=win
幕=scene
春秋=spring and autumn, a year
身影=figure, profile, silhouette
崇高=lofty, sublime, noble
奋斗=fight, struggle
杰宁=Jenin, name of a refugee camp
布什=the former U.S. president
巴勒斯坦=Palestine
联合国=The United Nations
安南=the former U.N. Secretary General
安理会=UN Security Council
泽维=Rehavam Ze'evi, former Israeli Minister of Tourism
约旦河=the Jordan River
杰里科=Jericho, city on west bank of Jordan river
巴勒斯坦人民解放阵线=Popular Front for the Liberation of Palestine
萨达特=Sadat, leader of PLO
红海=the Red Sea
舒贝基=Fuad Shobaki, former financial officer working for Arafat
加沙城=the Gaza City
伯利恒=Bethlehem
普伦德加斯特=Kieran Prendergast, Former Under-Secretaries-General 1998-2005
秘书处=(the U.N.) Secretariat
联合国大会=the U.N. Assembly
巴黎=Paris
乔冠华=former Chinese Foreign Minister and diplomat
概况=general situation, survey
设想=conceive, envisage
宣言=declaration, manifesto
拟订=draw up, draft, formulate
起草=draft, draw up
会员国=member state
签字国=signatory state (or power)
章程=written rules, regulations
宗旨=aim, purpose
人权=human rights
事项=item, matter
发言权=right to speak
投票权=right to vote
方案=scheme, plan, program
基金=(bank) fund, foundation
专门=specialized
人道主义=humanitarian
援助=help, aid, assistance
气象=meteorology, climatic phenomenon
单独=independent
涉及=involve, cover, be related to
方方面面=each and every aspect
派遣=send, dispatch
通信=communication
兼容性=compatibility
受害者=victims, sufferers
调运=allocate and transport
争取=strive for, fight for, win over, try to realize
低息=low-interest
贷款=loan
担保=guarantee
归根结底=in the final analysis, fundamentally
部长=minister
具=possess, have
全球=whole world, entire globe
永久=permanent
基本=basic, fundamental
原则=principle
歧视=discriminate against
自由化=liberalization
货物=goods, commodity, merchandise
游离=drift away, dissociate
知识产权=intellectual property rights
服务=service
法人=legal or juridical person
调解=mediate, make peace
权威性=authoritativeness
有效性=effectiveness
国际性=being international, global
货币=money, currency
三位一体=three in one
未能=fail to, be unable to
推行=carry out, practice, implement
契约=contract, deed, charter
启动=start, initiate
议案=proposal, motion
多边=multilateral
部长级=ministerial level
场所=location, place, locale, locus
审议=examine and discuss, review, deliberate
一致性=consistency
设=set up
理事会=council
预算=budget
核查=inspect, check, examine and verify
监督=supervise, superintend, control
评估=evaluate, appraise, assess
发展中国家=developing nations
法庭=court, court of justice, courtroom, tribunal
分歧=difference (of opinion, position), divergence
仲裁=arbitration
缔约方=parties or nations signing an agreement
须=must, have to
投票=vote, cast a vote
表决=decide by vote, vote
启用=start using, put to use, unveil
标识=sign, mark, symbol
弯曲=be circuitous, be anfractuous
弧线=pitch arc
球形=sphere
动感=sense of movement
设计者=designer, deviser
书法=calligraphy, penmanship
带有=have, possess
毛笔=brush pen, writing brush
起笔=start a stroke in writing a Chinese character
收笔=finish a stroke in writing a Chinese character
韵味=charm, appeal, implicit richness
轴心国=Axis Powers (i.e., Germany, Italy and Japan during World War II)
富兰克林 罗斯福=Franklin Roosevelt, the former U.S. president
敦巴顿橡树园=Dumbarton Oaks
波兰=Poland
联合国宪章=the U.N. Charter
安全理事会=the (UN) Security Council
经济及社会理事会=the (UN) Economic and Social Commission
托管理事会=the (UN) Trusteeship Council
国际法院=International Court of Justice
荷兰=The Netherlands, Holland
海牙=The Hague
儿童基金会=the (UN) Children's Fund
开发计划署=UNDP
世界粮食计划署=World Food Programme
关贸总协定=General Agreement on Tariffs and Trade
摩洛哥=Morocco
乌拉圭回合=the Uruguay Round
世贸组织=World Trade Organization (WTO)
日内瓦=Geneva
布雷顿森林会议=Bretton Woods Conference
世界银行=World Bank
哈瓦那宪章=Havana Charter
欧共体=European Economic Community
马拉喀什=Marrakesh, a city in Morocco
国际货币基金组织=International Monetary Fund
震惊=shock, astonish
喷气式客机=jet-propelled passenger plane, jet
撞入=crash into
塔楼=tower building
悄悄=softly, stealthily
全国性=nationwide, countrywide
悲剧=tragedy; tragic
撞毁=collide, strike with force and damage
新闻网=news website, news network
载=carry, load
空勤=aircrew, flight crew
乘务员=steward(-ess), vehicular attendant
驾驶员=driver, pilot
自称=call oneself, claim to be
资深=senior
官员=government official
否认=deny, disavow, repudiate
坠毁=(of a planet, etc.) fall and break, crash
建筑=architecture; buildings
火海=sea of fire
侧翼=wing; flank
防备=guard or take precautions against
疏散=evacuate, disperse
关闭=close, shut down
证实=confirm, verify, bear out
一连串=a succession/series of (actions, issues, etc.)
灾难性=catastrophic, calamitous, disastrous
恐惧=horror, fear, dread
坍塌=cave in, collapse
面对=face, confront, encounter
绑架=kidnap, take a person by force
暗杀=murder, assassinate
劫机=hijack an airplane
扣留=detain, hold in custody
分裂主义=separatism
极端=extreme
势力=force, power, influence
乃至=to the extent that, even （甚至）
主导=lead, dominant, guiding
合法性=legitimacy
国际=International
组织=organization
分享=share, partake of
替代=substitute for, replace
严厉=stern, severe, strict
庇护=shelter, asylum, shield
战线=front, frontline
落网=be caught, be captured or be arrested
帐户=account
冻结=freeze
伤及=hurt
无辜=innocent persons
特定=specific, specified
挂钩=link up with, establish contact with
随之而来=come along with
战火=flames of war
计=Count
舆论=public opinion
阶级=social class
尖锐=sharp(-pointed), keen
生成=form, produce
毒瘤=malignant tumor
成效=effect, result
参谋长联席会议主席=Chairman of the Joint Chiefs of Staff
世界贸易中心=World Trade Center
佛罗里达州=Florida
联邦调查局=FBI
波士顿=Boston
洛杉矶=Los Angeles
波音=Boeing
阿布.扎比=Abu Dhabi
巴勒斯坦自由民主阵线=Palestinian Democratic Front for Freedom
五角大楼=Pentagon
白宫=White House
匹兹堡=Pittsburgh
萨默塞特县=Somerset County
联合航空公司=United Airlines
新泽西州=New Jersey
纽瓦克市=Newark
双子大厦=Twin Towers
阿富汗=Afghanistan
新华网=Xinhua News Network
扩散=spreading, diffusion, proliferation
讽刺=ridicule, mock, satirize
意味=meaning, significance
杀伤性=lethality
同步=synchronize
生化武器=bio-chemical weapon
即将=soon, be about to
原子弹=atomic bomb
帷幕=curtain
相继=in succession, one after another
问世=(of a work) be published, come out
轰炸机=bomber (aircraft)
火炮=cannon, gun, artillery
核动力=nuclear powered
极其=extremely, exceedingly
人道=humane, humanitarian
禁止=prohibit, ban
防止=prevent, guard against
学术=learning, science
围绕=center on an issue; go around; revolve around
军控=arms control
类=category
专栏=special column
层出不穷=come out one after another
防扩散=anti-proliferation
谈论=talk about, discuss
残暴=cruel, brutal
平民百姓=commoner, civilian
掌握=grasp, master, know well
沙林=a highly toxic chemical nerve agent
直至=till, until, up to
血淋淋=bloody
警告=warning, cautioning, admonishing
无比=incomparable, unparalleled, matchless
追随者=follower
摧毁=destroy, smash
矛头=spearhead
指向=point to, direct to
究竟=exactly; after all
何许=what
头号=number one
建筑=architecture
大亨=VIP; big shot; bigwig
家族=clan, family
一阵子=a brief period of time
理想主义者=idealist
数以=have the amount of
行列=ranks, procession
入侵者=invader
圣战者=holy war fighters, crusaders
兴建=build, construct
军火库=munitions warehouse
围攻=besiege, lay siege to
缴获=capture, seize
杆=pole, shaft
步枪=rifle
形影不离=inseparable (as one's body and shadow)
激进=radical
撤=withdraw
之际=the time of; when
返回=return to, come (or go) back
入侵=invade, intrude
国王=king
求援=ask for reinforcement or assistance
反对派=opposition faction
踏=step on, tread
背叛=betrayal, treason
扮演=play the role of, act
角色=role (in a play, etc)
补给=supply, replenishment
离境=leave the country
避难所=refuge, asylum
松散=(of structure) loose
受过=receive, get
支援者=supporter
联络=contact
指示=instruction
层级=level
破获=crack a case and capture the criminal
置身=place oneself, stay
挂名=nominal, only in name
首脑=head, leader
通缉犯=(of criminal) wanted
悬赏=offer a reward
捉拿=arrest, catch
指控=accuse sb of, charge sb with
策划=plot, scheme, bring about
针对=be directed against, be aimed at
驱逐舰=destroyer
现年=current age, present age
招募=recruit, enlist
录相=videotape
蒙面=with face covered
期待=await, look forward to
以便=so as to
东京=Tokyo
本.拉登=Ben Laden
沙特.阿拉伯=Saudi Arabia
穆斯林=Moslem, Muslim
阿拉伯=Arab, Arabian, Arabic
贾拉拉巴德=Jalalabad (place name)
卡拉什尼科夫=Kalashnikov (AK-47)
伊斯兰=Islam
阿尔及利亚=Algeria
塔利班=Taliban
马来西亚=Malaysia
伊拉克=Iraq
科威特=Kuwait
阿勒法基=Al-Faqih, political opponent of King Fahd
法赫德=Fahd, King of Saudi Arabia
苏丹=Sudan
埃及=Egypt
也门=Yemen
阿尔巴尼亚=Albania
卡伊达=Qaeda
肯尼亚=Kenya
坦桑尼亚=Tanzania
原教旨主义=Fundamentalism
真主=Islamic God; Allah
风云人物=man of the year
尽头=end
元首=head of state
毕生=lifelong, all one's life
解放=liberation
获=obtain
奖=prize
传奇=legend
求学=pursue one's studies
土木工程=civil engineering
秘密=secretly
筹建=prepare to construct or establish sth.
暴风=storm
执委会=executive committee
此起彼伏=as one falls, another rises
斡旋=mediation
流血=bleed
九死一生=a narrow escape from death
政坛=political circles
游击队=guerilla
邮包=package
卫兵=guard, bodyguard
专车=special train or car
伏击=ambush
身亡=be dead
安然无恙=safe and sound, unscathed
遭遇=meet with, encounter (sth. bad)
沙暴=sandstorm
居然=unexpectedly
截=section
死里逃生=barely escape with one's life
橄榄枝=olive branch
继任=succeed
未竟=unfinished
圣城=holy city
古迹=historic site
动人=Moving
巅=top of mountain, summit
雄=powerful countries or people
废墟=ruins
再生=revive, be reborn, regenerate
风格=style
绝少=seldom; rarely
雷同=be identical
原貌=original appearance
城墙=city wall
巷=lane
狭窄=narrow, cramped
迷宫=maze
般=- like
四通八达=leading to everywhere, extend in all directions
石块=stone, rock
光滑照人=smooth and shiny
古朴=simple and unsophisticated (art, architecture, etc.)
摆设=furnish and decorate, arrange
异=differ from
散发=emit, send out
气味=smell
清真寺=mosque
围墙=enclosing wall
状=shape
长明灯=lamp that is on all the time
纪念馆=memorial hall
大屠杀=massacre
漆黑=pitch-dark, pitch-black
映=shine, reflect, mirror
沉重=heavy
呼唤=call out
稚气=childishness
烈士=martyr
公墓=public cemetery
墓地=cemetery
捐躯=die, sacrifice
瞻仰=look with reverence
墓碑=tombstone, gravestone
高楼大厦=high-rise
衰败=declined
风采=elegant demeanor
稍=slightly
逊色=inferior
宽容=tolerant
和睦=harmonious, concordant
彼此=each other
当街=on the street
白眼=supercilious look, disdain
街巷=streets and lanes
密布=be densely covered
镜头=camera lens
荷枪实弹=carry loaded guns, be ready for any emergency
哨兵=guard, sentry
厚实=thick and strong
垃圾=trash
提醒=remind
危机四伏=crisis-ridden, beset with crises
焦点=focus, focal point
诺贝尔和平奖=Nobel Peace Prize
约旦=Jordan
耶路撒冷=Jerusalem
拉宾=Rabin, fifth Prime Minister of Israel
拉马拉=Ramallah, a Palestinian city
基督=Christ
犹太=Jew(-ish), Judaism
地中海=the Mediterranean (Sea)
死海=the Dead Sea
犹地亚山区=Judea mountains
锡安山=Mount Zion
亚美尼亚=Armenia Quarter of Jerusalem
哭墙=the Wailing Wall
赫茨尔山=Herzl Hill
要道=thoroughfare
亡=die; conquer, subjugate
流亡=go into exile
同源=be of the same source
视为=regard as
出卖=betray
屡=repeatedly
迫害=persecution
狂潮=surging or turbulent tide
杀害=murder, kill, slaughter
血流成河=blood flows like a river
促成=bring about, facilitate
兴起=rise (of country, power)
知识分子=intellectuals
上台=assume power, rise to power
灭绝=annihilate, exterminate
战后=postwar
联军=allied forces
开战=start a war
逃离=escape, flee
核心=core; nucleus
加剧=intensify
极端份子=extremist
自杀爆炸=suicide explosion
定点=specify/designate a certain place
清除=eliminate
拟定=draft, prepare (document, policy)
策略=strategy
拭目以待=wait and see
托管=trust
诞生=be born
战绩=military success
停战=cease fire
才智=ability and wisdom
超群=surpass all others; be superior
步步高升=get one promotion after another
离职=leave one's post temporarily
赴=go to
深造=pursue advanced studies
总参谋长=chief of staff
闪电攻击=lightning attack
锋=sharp point or cutting edge of a tool; vanguard
置=put
辉煌=glorious
谴责=condemnation
从政=be engaged in politics
出任=assume (public office)
揭露=expose
辞职=resign
东山再起=return to power
再度=once more, a 2nd time
吞掉=swallow, annex
永久=permanent
极力=doing one's utmost
明媚=bright and beautiful
照耀=shine
签字=sign
注目=fix one's eyes on
领袖=leader
握手言和=shake hands to stop fighting
化干戈为玉帛=bury the hatchet, turn hostility into friendship
赞誉=praise
撤军=withdraw troops
雏形=model miniature, embryonic form
极右势力=extreme rightists
叛徒=traitor
卖国贼=traitor of one's country
极端分子=extremist; radical
心声=heartfelt wishes
国防部长=defense minister
中世纪=the Middle Ages
希特勒=Hitler
黎巴嫩=Lebanon
叙利亚=Syria
犹太教=Judaism
基督教=Christianity
伊斯兰教=Islam, Islamism, Muslim
犹太复国主义=Zionism, the international Jewish political movement that originally supported the reestablishment of a homeland for the Jewish People in Palestine.
上帝=God
以色列国=Israel
贝尔福宣言=Balfour Declaration
哈马斯=Hamas, "Islamic Resistance Movement", an Islamic Palestinian socio-political organization
国际联盟=the League of Nations (1920-1946)
中东战争=Mideast War
塔巴协议=Taba Agreement
大马士革=Damascus
罗得岛=Rhode Island
加沙地带=Gaza Strip
西奈半岛=Sinai Peninsula
戈兰高地=Golan Heights
开罗=Cairo
安曼=Amman
迦南=Canaan
伊扎克.拉宾=Yitzhak Rabin, former Prime Minister of Israel, 1994 Nobel Prize winner
特拉维夫=Tel Aviv
奥斯陆=Oslo
搭载=take, travel by, pick up passengers/freight
航天员=astronaut
舱=cabin, module
着陆=land
载人=manned
圆满=satisfactory, perfect
太空=outer space
飞船=spacecraft, spaceship
调姿=adjust position
轨道=railway track, orbit
分离=separate, separation
制动=apply(ing) the brakes
大气层=atmosphere
显示屏=display screen
表明=indicate, make known
等候=wait, await, expect
降落伞=parachute
天线=antenna
预测=predict, forecast
国际象棋=chess (international style)
回合=round, bout
较量=trial of strength or skill, contest, competition
排名=ranking
特级=special grade, superfine
大师=great master
激战=fierce fight; pitched battle, fierce battle
三维立体=three-dimensional
虚拟现实=fictitious reality; virtual reality (VR)
真实=true, real
棋盘=chessboard
挪动=move, shift
即可=That will do
棋手=chess player, chess master
抱怨=complain
主办=sponsor, host
战平=tie (in a competition)
战败=be defeated，defeat
棋艺=skill (in a board game)
出色=excellent, outstanding
引人注目=noticeable, conspicuous
日新月异=change with each passing day, develop rapidly
拓展=expand, extend, broaden
延年益寿=prolong life
基因=gene
尽早=as early as possible
医治=cure, treat
发病=get sick, fall ill
克隆=clone
福音=gospel; good news
细胞=cell
肝脏=liver
长寿=long-life, longevity
转基因=transgenic
抗病=resist disease
防病=prevent disease
疫苗=vaccine
乙型肝炎=hepatitis B
突飞猛进=advance by leaps and bounds
遨游=roam, travel
憧憬=yearning for, longing for
宇宙飞船=spaceship
月球=moon
一饱眼福=feast one's eyes on something
空间站=space station
或许=perhaps, maybe, probably
星球=celestial/heavenly body (e.g., planet, satellite, etc.)
机器人=robot
移动电话=cell phone
表情=expression
行动自如=move freely
能歌善舞=good at singing and dancing
吸尘=vacuum
老弱病残=the old, weak, sick and handicapped
电冰箱=refrigerator, fridge
采购=make purchases
微波炉=microwave oven
下载=download
食谱=recipe, cookbook
事先=in advance, beforehand
冷冻=freeze
鸡鸭鱼肉=all kinds of meat
解冻=thaw, defrost
美味可口=delicious
包罗万象=all embracing, all inclusive
九牛一毛=a drop in the bucket/sea
伦理=ethics, moral principles
道德=morals, morality, ethics
长远=long-term
检验=test, examination, inspection
杨利伟=a Chinese astronaut
温家宝=Chinese Premier
加尼.卡斯帕罗夫=Garry Kasparov, a world famous chess player
深蓝=Deep Blue, IBM's chess program
三维福利兹=name of a computer
史话=stories about historical events
点燃=light, kindle, ignite
液体=liquid
驱动=drive
火箭=rocket
宇航=space navigation, space flight
巡航导弹=cruise missile
模拟=simulation
计算器=calculator
配有=be furnished/equipped with
报复=Retaliate
击中=hit the point or target
人造卫星=man-made satellite
环绕=surround, encircle, rotate
宇航员=astronaut
驾驶=fly, drive
次日=the next day, tomorrow
对接=docking, linking up
礼炮=saluting/ceremonial cannon
返航=return flight
阀=valve
丧生=meet one's death, lose one's life
发射架=launcher
升空=rise to the sky
机组=flight crew
轨道站=orbit station
航天局=space bureau
庞然大物=huge monster, giant
平方米=square meter
前锋=vanguard, front
深远=far-reaching
空前=unprecedented, as never before
渗透=osmosis; permeation, seeping
热潮=upsurge, mass enthusiasm
实验室=lab, laboratory
先声=first sign
起步=start (a task), make a beginning
日长夜大=grow daily
革命性=revolutionary
传真=fax, facsimile
丰富多彩=rich, varied, and colorful
服务业=service industry
现代=modern
预言=predict, foretell
概念=concept, idea
界定=decide, define
联网=network, networking
区分=distinguish, differentiate
人际关系=interpersonal relationships
宁愿=would rather, prefer
愿=hope, desire, wish, be willing
互动=interaction
异化=alienation
疏离=separate, be estranged and keep and keep apart
乃是=be
双刃剑=double-edged sword
便利=convenience
网络化=becoming networked
昂贵=expensive, costly
代价=price, cost (of doing sth.)
莱特兄弟=the Wright Brothers
戈达德=Robert Hutching Goddard （1882-1945）
马萨诸塞州=Massachusetts
佩讷明德=Peenemunde (place name, a village in northeast Germany)
阿格莱盖特=Aggregat (A Nazi German rocket series.)
国家航空航天局=NASA (National Aeronautics and Space Administration)
加加林=Yuri Gagarin (person's name)
约翰.格伦=John Glenn (person's name)
弗拉基米尔=Vladimir (person's name)
科马罗夫=Komarov (person's name)
联盟号=Soyuz spacecraft (in former Soviet space program)
格奥尔基=Georgi (person's name)
别列戈沃伊=Beregovoi (person's name)
哥伦比亚号=Space Shuttle Columbia
挑战者号=Space Shuttle Challenger
卡纳维拉尔角=Cape Canaveral
肯尼迪航天中心=Kennedy Space Center
和平号=Mir (an orbital station; world's first continuously inhabited long-term research station in space)
礼炮一号=Salyut 1 (the first space station of any kind)
拜科努尔=Baikonur (place name)
暴风雪号=Buran (a Soviet space shuttle program)
伦敦=London
探险者号=Explorer (U.S. space shuttle)
阿波罗=Apollo (space flight program undertaken by NASA during 1961-1975)
