贵姓=honorable surname
好=well, good (Adj.)
很=very, very much (Adv.)
再见=good-bye; bye!
叫=to be called
小姐=Miss, young lady
老师=teacher
什么=what
们=a suffix for the plural of persons
你们=you (plural)
名字=name
那=that
呢=modal particle
你=you
您=you (polite form)
请问=may I ask…
先生=Sir, Mr.
学生=student
是=to be
太太=Mrs.
我=I, me
谢谢=thanks; thank you
姓=be surnamed, surname
也=also
早=good morning; early
这=this
零=zero
八=eight
班长=squad leader
日本=Japan
上等兵=Private First Class
不=no, not
的=particle
电话=telephone
都=all (Adv.)
二=two
士官=Sergeant
中国=China
英国=England
中国人=Chinese people
国=country, nation
美国=America, U.S.A.
海军=Navy
号码=number
她=she, her
九=nine
陆军=Army
空军=Air Force
六=six
吗=particle, question marker
我们=we, us
哪=which
七=seven
人=human being, people
日文=Japanese language
三=three
先生=husband
十=ten
谁=who, whom
四=four
他=he, him
太太=wife
同志=comrade
中文=Chinese language
文=language, literature
英文=English language
五=five
系=department (of school)
一=one
爱人=spouse, husband or wife
爸爸=father, dad, daddy
对不起=I'm sorry; excuse me
工程师=engineer
大哥=eldest brother
大=big; old
大夫=doctor
大学生=college student
兄弟姐妹=brothers and sisters; siblings
弟弟=younger brother
对=right, correct (Adj.)
多=how (Pron.)
男孩儿=boy
女孩儿=girl
女儿=daughter
儿子=son
哪儿=where
二哥=second eldest brother
哥哥=elder brother
个=measure word
工人=workers
工作=to work / work, job
没关系=it doesn't matter; never mind
军官=military officer
孩子=child, children
和=and
几=how many? (from 2 to 9)
家=family, house, home
教=teach
姐姐=elder sister
今年=this year
军人=military personnel
看=to see; to look at
口=measure word / mouth
两=two
了=particle
妈妈=mother, mum, mummy
没有=do not have
妹妹=younger sister
照片=photograph, picture
岁数=age; years (of age)
岁=year (of age)
中学=middle school
有=to have
在=in, at, on
西安=Xi'an (a city)
百=hundred
北京=Beijing, Peking
北方人=northerner
东部=east, eastern part (N.)
西部=west, western part
城市=city
大陆=mainland
德州=Texas
地图=map
基地=base
广东=Guangdong (a province)
华盛顿州=state of Washington
多=plus, over (Nu.)
这儿=here
那儿=there
三藩市=San Francisco
南方人=southerner
父亲=father
父母=father and mother; parents
香港=Hong Kong
还=still
还是=or
加州=state of California
老家=original home, hometown
旧金山=San Francisco
天津=Tianjin (a city)
军事=military (N.)
人口=population
母亲=mother
纽约州=state of New York
纽约市=New York City
千=thousand
生=to give birth
省=province
台湾=Taiwan
万=ten thousand
位=measure word for people (polite)
住在=to live in
州=state, province
河北=Heibei Province
出生=to be born
海军陆战队=Marine Corps
国防语言学院=Defense Language Institute
跟=and
家庭=family
家乡=hometown
家=measure word for business establishment
教书=teach
邮局=post office
里=a suffix to indicate location
那里=there
忙=busy
怎么样=how
名片=business card
男朋友=boyfriend
朋友=friend
上尉=Captain
上士=Sergeant (E6)
少校=Major
身体=body, health
中士=Sergeant (E-5)
所=measure word for house, school, etc.
同学=classmate, schoolmate
想=to think
学校=school
银行=bank
只=only (Adv.)
