政体=polity, political system
占有=occupy, hold
党=political party
基层=primary level, grass-roots
支部=branch of political parties or organizations
乡=township
政府=government
主席=chairman
长=leader, chief
村=village
县=county
特区=special administrative region
首长=leading cadre, senior officer or official
民主化=democratization
步骤=step，procedure
中央=central authorities (of a state, party, etc.)
委员会=committee
总=general, head, chief
书记=Secretary
民主=democracy
观摩=view and emulate, inspect and learn from each other's work
乡镇=township, villages and towns
纪实=record of actual event
公众=general,
脱口而出=blurt out
问号=unanswered question, unsolved problem
外事=foreign affairs
越过=cross over
浩瀚=vast
事后=afterwards
令人兴奋=exciting
应=answer to, respond to
主任=director
抵达=arrive at
为期=last a certain period of time
继=follow, continue from
权利=rights
换届=re-elect when a term of office expires
毛毛细雨=drizzle
现场=scene, site
泥泞=muddy
候选人=candidate
差额=difference
代表=representatives
选民=Voters
参选=participate in voting
整个=Whole
持续=continue
选票=votes, ballot
委托=commission, entrust
当选=be elected
辜负=let down
信任=trust
带头=take the lead
带领=lead
奔=run straight towards
小康=well-do-do, comfortably off
结识=become acquainted with
握=hold
曾=once； ever
驾驶=drive
并肩=side by side
战壕=Trench
目睹=Witness
依法=in accordance with the law
行使=exercise, make use of
加深=deepen
友谊=friendship
新华社=Xinhua News Agency
人民日报=People's Daily
卡特中心=The Carter Center
全国人大=The National People's Congress (NPC)
荣昌县=Rongchang County
昌元镇=Changyuan Township
抗日战争=War of Resisting Japanese Invasion
第二次世界大战=World War II
雪佛莱=Chevrolet
法西斯=Fascist
北京语言文化大学=Beijing Language and Culture University
全称=full name
社会主义=socialism
政治局=politburo
常委=standing committee member
委员=committee members
部份=part, component
候补=alternate
纪律=discipline
检查=check, examine, inspect
军事=military affairs
组织=organize, organization
宣传=publicize, publicity, propaganda
统战=united front
联络=contact, liaison
书记处=secretariat
民主党派=democratic parties
构成=constitute
常务委员会=standing committee
常委会=standing committee
委员长=chairman of a committee
立法=legislative
权力=power
全体会议=plenary meeting
听取=listen to
总理=premier, prime minister
部长=minister
外交=foreign affairs, diplomacy
秘书长=secretary-general
任期=term of office
连续=continue
国务委员=state councilor
殖民地=colony
封建=feudal
帝国主义=imperialism
封建主义=feudalism
官僚=bureaucrat
资本主义=capitalism
压迫=oppression
主张=advocate, advocacy
剥削=exploit, exploitation
革命=revolution
信仰=believe in, belief
以致于=（so...) as to
分裂=split
汇合=converge
起义=uprise, uprising
开创=create, start
武装=armed forces
夺取=win, seize
政权=power, regime
击退=defeat, repulse
围剿=encircle and suppress
路线=line, route
失败=lose, failure
粉碎=smash
灭亡=(of a country) be destroyed
企图=attempt
深入=go deep into
敌后=area behind enemy lines
游击=fight guerrilla warfare
内战=civil war
战役=battle
退守=withdraw and stand on the defensive
生产力=productive force
急于求成=overanxious for quick success
调整=adjust
崩溃=collapse
边缘=verge
综合=comprehensive
国力=national power
指导=guide, guidance
遗留=leave as legacy
根本=fundamental
前进=go forward
斗争=struggle
杰出=outstanding
人物=people
卓越=excellent
中华人民共和国=People's Republic of China
中国共产党=Communist Party of China
胡锦涛=Hu Jintao
中国人民政治协商会议=Chinese People's Political Consultative Conference
孙中山=Sun Yat-sen
宋庆龄=Soong Ching Ling
全国人民代表大会=National People's Congress
中国国务院=China's State Council
美国国务院=U.S. State Department
马克思列宁主义=Marxism-Leninism
俄国=Russia
十月革命=October Revolution
北伐战争=Northern Expedition
南昌起义=Nanchang Uprising
秋收起义=Autumn Harvest Uprising
广州起义=Guangzhou Uprising
中国工农红军=The Red Army (of Workers and Peasants of China)
毛泽东=Mao Zedong
王明=Wang Ming
长征=Long March
西安事变=Xi'an Incident
七七事变=Marco Polo Bridge Incident
八路军=Eighth Route Army
新四军=New Fourth Army
辽沈=Liaoning and Shenyang
平津=Beiping and Tianjin
淮海=Name of the area where the Huaihai Campaign was waged
大跃进=Great Leap Forward
文化大革命=Cultural Revolution
刘少奇=Liu Shaoqi
朱德=Zhu De
邓小平=Deng Xiaoping
一国两制=One country, two systems
交接=hand over; take over
首相=prime minister
嘉宾=honored guest
庄严=solemn
升=rise
此时此刻=at this very moment
投=cast
声明=statement
如期=as scheduled
宣告=declare
主权=sovereignty
盛事=grand occasion
正义=justice
永远=forever
沧桑=vicissitude
崭新=brand new
创造性=creativeness, creativity
构想=conception, idea
指明=point out
时刻=moment
怀抱=bosom
亲切=affectionate
坚定不移=steadfast
防务=defense matters
依据=according to
管理=management
司法=judicature
终审=final adjudication
循序渐进=proceed step by step
航运=shipping
正当=legitimate
繁荣=flourishing
光荣=honorable
爱国=patriotic
归根到底=in the final analysis
坚强=strong, firm
后盾=backup force
乡愁=homesickness
枚=for coins, stamps, bombs, etc.
新娘=bride
方=for square things
坟墓=tomb
浅=shallow
海峡=channel, strait
支=for long, thin, inflexible objects
清远=(of sound) clear and lingering far
笛=bamboo flute
模糊=blurred
怅望=listlessness
仿佛=seem like, as if
挥=Wave
别离=leaving, bidding farewell
离别=apart, leave
年轮=annual ring
襁褓=swaddling clothes
掳=capture
肉体=flesh, human body
依然=still, as before
保管=take care of
灵魂=soul
梦寐=dream
生母=biological mother
乳名=childhood name
江泽民=Jiang Zemin, former President of PRC
查尔斯王子=Prince Charles
布莱尔=Blair, former British Prime Minister
香港特别行政区=Hong Kong Special Administrative Region
中央人民政府=Central People's Government of the PRC
余光中=a noted modern Taiwanese poet, prose writer, critic, and translator
席慕容=a noted contemporary Taiwanese poet
闻一多=a noted modern Chinese poet, scholar, and fighter for democracy
明珠=bright pearl, jewel
枢纽=hub
占领=seize, occupy
统治=rule
签署=sign officially
归还=return
统一=unified
干预=intervention, interference
名义=name
海岛=island (in the sea)
落=fall
势力范围=sphere of influence
协议=agreement
自治权=autonomy
类似=be analogous, be similar
土壤=soil
肥沃=(of land) fertile, rich
原住民=aborigines, indigenous people
抓住=catch hold of, grab
大力=energetically, vigorously
加工业=processing industry
带动=drive, spur on
誉=praise, acclaim
致力=devote oneself into
产业=industry
半导体=semiconductor
精密=precise
制药=manufacture medicine
新兴=new and developing
支柱=pillar
急剧=sharply, rapidly
执政=be in power
允许=allow, permit
党派=parties, fractions
中国化=sinicize, sinicization
反对=oppose, opposition
合法=legitimate, legal
国会=congress
承诺=promise, commit, commitment
商务=business
防御性=defensive
会谈=talks
公报=communique
访问=visit
正视=face up to, face squarely
现实=reality
体认=recognize
岸=shore, bank
事宜=matters
交换=exchange
会见=meet with (especially a foreign visitor)
全体=all
基于=based on, in view of
关切=concern
发布=issue, release
愿景=vision of wish
本着=out of
善意=goodwill
求同存异=seeking common ground while reserving differences
开启=open, start, initiate
协商=consult, consultation
互信=mutual trust
迭=repeatedly
遭=meet with (disaster)
形势=situation
关键=key
陷入=sink into
对抗=resist, confront, confrontation
恶性=vicious
循环=cycle
步入=step into
良性=benign
谋求=seek
双赢=win-win
局面=situation
光明=brightness
灿烂=brilliant
发扬=carry forward
有助于=be helpful to
消弭=eliminate, terminate
隔阂=(of feeling and thought) estrangement
增进=promote
累积=accumulate, accumulation
共识=common understanding
潮流=trend
符合=be consistent with the
上述=above-mentioned
尽速=as soon as possible
共谋=collaborate
福祉=well-being
平等=equal
推进=advance
终止=terminate, stop
敌对=hostile
建构=construct
架构=structure
机制=mechanism
冲突=conflict
展开=launch, carry out
经贸=economy and trade
直航=direct flight
销售=sales
进而=and then, after that
民众=masses
参与=participate
寻求=seek
沟通=communication
党务=party affairs
研讨=study and discuss
切身=personal
磋商=consultation
界=community, circle
商讨=discuss
前景=Prospect
珠江=Pearl River
香港岛=Hong Kong Island
九龙=Kowloon
新界=New Territories
鸦片战争=Opium War
葡萄牙=Portugal
澳门特别行政区=Macao Special Administrative Region
台湾岛=Taiwan Island
金门=Kinmen
马祖=Matsu
澎湖=Penghu
高雄=Kaohsiung
基隆=Keelung
台中=Taichung
嘉义=Chiayi
台南=Tainan
亚洲四小龙=Four Little Dragons of Asia
民进党=Democratic Progressive Party
陈水扁=Chen Shui-bian
中国国民党=The Chinese Nationalist Party
连战=Lien Chan
中央政治局=Politburo of CCP
贾庆林=Jia Qinglin
九二共识=92 Consensus
台独=Taiwan Independence
亚太=Asia-Pacific
三通=Three Links
世界卫生组织=World Health Organization
代号=code name, code number
机械化=mechanization
步兵=infantrymen
演习=drill, exercise
信号弹=signal flare
炮声=sound of cannonade
序幕=beginning of a major event, prelude
装甲=armored, steel-plated
轰鸣=thunder, roar
响彻=reverberate through
率先=first
攻击=attack
巧妙=skillful
伪装=pretend, feign
火力=firepower
防空=air defense
掩护=screening, shielding
预定=predetermine, fix in advance
集结=mass (esp. of troops), build up
一阵=for bullet firing, rain, wind, etc.
弹雨=a hail of bullets
直升机=helicopter
侦察=reconnaissance
分队=detachment
挺进=(of troops) press forward
坦克=tank
防御=defense
阵地=position
撕=tear
缺口=gap
搭乘=travel by, ride
战车=war vehicle
避开=avoid
敌=enemy
纵深=depth (of defense works)
节节败退=suffer successive defeats
困=be stranded
孤立=isolated
高地=heights
等待=wait
援军=reinforcements
爆破=blast
发起=launch
总攻=general offensive
低空=low altitude
突袭=sudden attack
全副武装=fully armed
特种兵=special forces
突击队=commando units
全方位=omnidirection
夹击=attack from both sides
电子战=electronic warfare
心理战=psychological warfare
网络=network
假=fake, false
侵入=invade
干扰=interfere, interference
盘旋=circle, hover
劝降=induce to surrender
传单=leaflets
空投=airdrop
空飘=airborne
扯=haul, pull
枪炮=guns
骤然而止=stop suddenly
少将=major general
信息=information
体现=reflect
作风=style
国防=national defense
观察员=observer
驻=station
武官=military attache
迄今为止=up to this day
规模=scale
军事家=military strategist
将军=general
著=write
名著=masterpiece
兵书=war manual
古今中外=at all times and in all countries
论述=expound, elaborate
运用=apply
经营=manage
决策=decision-making
了不起=extraordinary
译=translate
推崇=hold in high esteem
兵法=Art of War
克敌制胜=defeat the enemy and win victory
战术=tactics
合=combine
严密=well-conceived, carefully worked out
计谋=scheme
敌人=enemy
攻=attack
兵力=military strength
进攻=attack, assault
分散=scatter
正确=correct
名言=famous saying
君=lord, prince, king, emperor
命=order
将帅=high-ranking commander
机动=flexible
机械=inflexible, rigid
死板=rigid
招致=incur, bring about, result in
制订=formulate
对策=counter-measure
铁拳-2004=Iron Fist -2004 Military Exercise
济南军区=Jinan Military Region
文莱=Brunei
菲律宾=the Philippines
塔吉克斯坦=Tajikistan
孙子兵法=The Art of War by Sunwu
贺龙=(1896-1969) PLA marshal; prominent military leader in early Communist movement
罗荣桓=(1902-1963) Communist general, one of the Ten Great Marshals
叶剑英=(1898-1985) Communist general, one of the Ten Great Marshals
陈毅=(1901-1972) former commander of New Fourth Army, 2nd Minister of Foreign Affairs
春秋战国=Spring and Autumn Period (777 - 476 B.C.)
吴国=the Wu Kingdom
谋攻篇=Strategic Attack, one chapter in the Art of War
九变篇=Variations and Adaptability, one chapter in the Art of War
渊源=origin
思想家=thinker, ideologist
亲仁善邻=maintain good relations with neighboring countries
反映=reflect
天下太平=the world/country is in peace
慎重=prudent, cautious
对待=treat
后发制人=gain mastery by counterattacking
进程=process, progress
团结=unite
外侮=foreign/external aggression
始终=from beginning to end
主题=subject, theme
继承=carry on, carry forward
巩固=consolidate, strengthen
抵抗=resist, stand up to
侵略=invasion and looting, aggression
制止=prevent, curb
颠覆=overturn
保卫=defend, safeguard
完整=integral
宪法=constitution (of a country)
赋予=entrust
职责=duty
霸权主义=hegemonism
强权政治=power politics
捍卫=protect
自卫=defending oneself, self-defense
独立自主=maintain independence and self-reliance
自力更生=rely on one's own efforts
服从=obey, submit (oneself) to
大局=general situation
实力=actual strength
积极=active
支援=support, assist, aid, help
犯=violate
必=certainly; necessarily
少量=small amount or quantity
核武器=nuclear weapon
出于=be due to, stem from
全民=all the people
人民战争=people's war
完善=perfect, consummate
动员=mobilize, arouse
立足=stand, base oneself upon
现有=existing
领域=field, territory
深刻=deep, profound
变革=transformation, change
高技术=high technology, high-tech
防卫=defend
精兵=crack troops
革命化=revolutionize
正规化=normalize
依靠=rely on, depend on
型=model, type, pattern
效能=efficacy, usefulness
密集=concentrate, crowd together
转变=change, transform
编制=establishment
扩张=expand, extend
行为=behavior
和平共处=peaceful coexistence
集团=group; aggregation
驻军=station troops, base troops
军备=armament, arms, weaponry
公正=just, fair
均衡=balanced
裁军=disarmament
现役=active military service
预备役=reserved duty or service
民兵=people's militia
隶属=be subordinate to
总部=(general) headquarters
军区=military region
行动=move, action, movement
军务=military affairs; military administrative matters
后勤=rear service, logistics
财务=finance
军需=military supplies
油料=oil
基建=capital construction
审计=audit
科研=scientific research
订购=subscribe, place an order for
电子信息=electronic information
炮兵=artillerist, artilleryman
装甲兵=armored force
工程兵=engineering corpsman
通信兵=signalman
防化兵=anti-chemical warfare corps
陆军航空兵=ground airman
舰艇=warships, naval vessels
潜艇=submarine
航空兵=airman
岸防兵=shore protect forces
陆战队=marines
地空导弹=surface-to-air (guided) missile
高射炮=anti-aircraft gun
雷达兵=radar operator
空降兵=paratroops
战略导弹部队=strategic missile troops
常规=conventional
战区=war zone
行政区划=administrative district divisions
设置=set up, establish
辖=have jurisdiction over, administer
若干=a certain number/amount
集团军=group army
卫戍区=garrison command
警备区=garrison command
职能=function
属=be subordinate to, be under
兵役=military service
骨干=backbone, core
序列=sequence, alignment, array
依照=according to, in accordance with
协助=assist, help
战时=wartime
动员令=mobilization order
担负=bear, take on, be charged with
双重=double, dual, twofold
勤务=service, daily duties
总参谋部=General Staff Headquarters
总政治部=General Political Department
总后勤部=General Logistics Department
总装备部=General Equipment Department
中国人民武装警察=Chinese People's Armed Police
第二炮兵=the Second Artillery
兰州=Lanzhou (capital of Gansu Province)
南京=Nanjing (capital of Jiangsu Province)
市场经济=market economy
杂谈=casual/random talk
相声=cross talk, comic dialogue
顺溜=smooth, easy
计划经济=planned economy
作主=make decision
比方说=for instance
国营=state owned
开门=open the door for business
上门=deliver to the door
火车头=locomotive
一转眼=in a blink of an eye
比方=analogy, comparison
做梦=dream
跳槽=job hopping
创业=start an undertaking, start/build a business
汇集=gather
软件=software
智商=intelligence quotient (IQ)
风云变幻=constant change of events, changeable situation
富翁=wealthy man
不足为奇=not at all surprising
炼=temper with fire
涌进=pour into
笔挺=well ironed
一丝不乱=tight and neat
梳=comb
经典=classical
身价=value of a person
皇帝=emperor
特困生=poorest student
欠=owe
债=debt
筹集=raise (fund)
中途=half-way
辍学=discontinue one's study
一无所有=have nothing
穷得冒烟=extremely poor
学府=higher institution
誓言=oath
名堂=result, achievement
攻读=diligently study
推销=sell, market
当场=on site, then and there
拍板=decide
黑客=hacker
浏览=browse
黄色=pornography
暴力=violence
研制=develop
终端=terminal
监控=monitor
非法=illegal
争先恐后=strive to be the first and fear to lag behind
加盟=join in
如今=at present
摇钱树=a ready source of money
应有=deserved
报偿=reward
中关村=Zhongguan Village
硅谷=Silicon Valley
比尔.盖茨=Bill Gates
杨坚=Yang Jian
固原县=Guyuan County
需求=demand
诸如=such as
效率=efficiency
低下=low
缺乏=lack, be short of
弊病=malady
阻碍=impede, impediment
强调=stress, emphasize
前提=premise, prerequisite
预先=in advance, beforehand
指令=instruction, order, direction
至今=up to now
国民生产总值=GNP, national gross product
尤其=in particular
资料=means, materials
农产品=agricultural products
产值=production value
指令=order, direction, instruction
而今=today, now
活力=vitality
引人瞩目=attracting attention
证券交易所=stock exchange
成就=achievement
过渡=transition
转型期=transitional period
譬如=for example
生态=ecology
差距=gap
拉大=widen
失控=lose control
下岗=be laid off
数目=number, amount
比重=proportion
融入=merge into
已故=deceased, the late
目的=purpose
中央集权=centralization of power
大致=roughly, generally
阶段=stage, phase
联产承包=household contracting
责任制=responsibility system
农民=farmer
国营=owned by state
企业=enterprise
试点=pilot project, trial project
扩大=expand
自主权=autonomy, right to act on one's own will
创办=found, set up
经济特区=special economic zone
配套=match, matching
侧重=focus on
突破=break through
旧有=old, existing
桎梏=shackles
转向=turn to
创新=blaze new trials, bring forth new ideas
实施=put into effect
财税=finance and taxation
外贸=foreign trade
外汇=foreign currency
流通=circulation
深化=deepen
股份制=share/stock system
初步=initial, preliminary
作法=practice
摸索=fumble
试验=experiment
摸=touch, feel
石头=stone, rock
讲求=stress, emphasize, pay attention to
实效=actual effect
世界贸易组织=World Trade Organization
吃香=popular, well-liked, welcomed
外资=foreign capital
合资=joint capital
打交道=deal with
见识=knowledge experience
向往=yearn for, look forward to
企业家=entrepreneur, enterpriser
经理=manager
明星=movie star
歌星=singing star
设计师=designer, architect
摄影师=photographer, cameraman
热门=popular
浪潮=tide, wave, trend
文艺=literature and art
知识=intellect, knowledge
从=engage in, join
下海=engage in business, working in a private sector
岗位=post, station
副食品=non-staple food or foodstuff
住房=housing
支出=expenditure
服饰=dress and personal adornment
必需=essential, indispensable
花费=cost, expenditure
占据=occupy, hold
望子成龙=expect children to be successful
心切=eager, impatient, anxious
勒紧裤腰带=save money from living expenses
居室=room
装修=decorate, decoration
承受=bear
热衷=be keen, be enthusiastic
置办=buy, purchase
家业=family property, property
耐用=durable
消费=consume, consumption
注重=lay stress on, pay attention to
养身=maintain good health
金钱=money
闲聊=chat
老头=old man; husband
忙碌=busy
路过=pass (a place)
煤炉=coal stove
铝=aluminum
盆=basin, tub, pot
土豆=potato
辣椒=hot pepper, chili
瓷=chinaware, porcelain, china
眯=narrow one's eyes
沙子=sand, grit, small grains
安宁=peaceful, tranquil
朴素=simple, plain, frugal
正巧=by a happy chance; at just the right time
攀谈=chitchat, strike up a conversation
近视=Myopic, shortsighted
罩衣=overall, dustcoat
自豪=Proud of oneself or someone/something related to self
小心翼翼=very careful
衣着=clothing, headgear and footwear
陈旧=old, outdated, obsolete
微薄=meagre, scanty
退休=retire
度日=subsist (in hardship), eke out a living
搀扶=support gently by the hand or arm
背影=view of sb.'s back, figure viewed from behind
温馨=pleasant and sweet
悠闲自在=leisurely and carefree
下脚菜=leftover bits and pieces
坚决=firm, determined, resolute
缝=sew clothes
心平气和=calm, even-tempered and good-humored
不假思索=without thinking
充斥=Congest, full of, be flooded with (negative connotation)
简朴=simple and unadorned, plain
平凡=ordinary; common
体会=realise, know or learn from experience
滋生=multiply, breed, provoke
相濡以沫=mutual help and relief in time of poverty
同甘共苦=share joy and sorrow
香车宝马=fragrant cars and treasure horses （wealthy life）
富裕=well-to-do, well off
感受=feel, experience
永无止境=without end, endless
追求=seek, pursue, go after
焦虑=worrying, anxious, apprehensive
担忧=worry, be anxious
肯德基=Kentucky Fried Chicken
眼下=presently
超前=surpassing the present, far ahead
畸形=abnormal
愈演愈烈=grow in intensity, get worse and worse
看齐=keep up with, emulate
笔者=(present) writer; I, the author
零食=between-meal nibbles, snacks
方便面=instant noodles
口服心服=be sincerely convinced
八宝粥=flavored porridge made of rice, peas, nuts, etc.
口服液=oral liquids
钙奶=milk with calcium
媒介=media
情有独钟=love only one person or thing in one's heart
荣=honorable
成人=adult
社交=social contact, interaction
要好=be on good terms, be close friends
蛋糕=cake
扫兴=disappointed or discouraged
索性=simply, just, might as well
设宴=give a dinner, banquet
款待=treat cordially; entertain
统计=statistics
崇尚=uphold, advocate
蹬=wear (shoes etc.)
涉足=set foot in
精品=top quality articles, fine commodities
流连=be reluctant to leave or part with
时装=fashionable dress; latest fashion
不惜=not stint
一掷千金=squander money
美容店=beauty shop
崇拜=worship, adore
忍俊不禁=can't help laughing
脸型=cast of one's face
嘴形=shape of the mouth
来源=source, origin
索要=ask for, demand, claim
高消费=extravagant spending
独生子女=an only child
当代=present age, contemporary
皇帝=emperor
公主=princess
娇生惯养=pampered since childhood
导致=cause, lead to
误区=erroneous zone
推波助澜=add fuel to the flames
消极=negative, passive, inactive
后果=fallout, consequence, aftermath
不容忽视=not to be ignored
滋长=grow, develop
奢侈=luxurious, extravagant, excessive
拜金=money worship
思潮=trend of thought, ideological trend
泛滥=be in flood, overflow, inundate
享乐主义=hedonism, dilettantism
抬头=prevail, gain ground
品德=moral character, morality
身心=body and mind
不利=bad for, not beneficial to
惩治=punish
贪官=avaricious official, corrupt official
伏法=be executed
核准=check and approve
高级=higher level
法院=court
受贿=accept bribery
行贿=bribe
巨额=huge amount
财产=property, assets
案=case
终审=final judgment
裁定=rule, adjudicate
死刑=death penalty
事务局=bureau of general affairs
局长=bureau chief
助理=assistant
谋取=seek
收受=accept
索取=demand, exact
财物=money and things
共计=total
查证=check and verify
亦=also
证据=evidence
查明=prove through investigation
中级=intermediate level
数罪并罚=combined punishment
判处=sentence
剥夺=deprive
没收=confiscate
追缴=demand payment of illegally obtained wealth
上诉=appeal
审理=trial
一审=first trial
认定=firmly believe, maintain
适用=applicable
量刑=measurement of penalty
适当=suitable, proper
审判=trial
驳回=reject, turn down
维持=maintain
原判=original sentence
报请=submit a written report requesting instructions
复核=supreme court review of lower court death sentence
遵纪守法=observe discipline and law
权=power
交易=trade, conduct a transaction
恶劣=vile, odious, very bad
数额=number, amount
遭受=suffer, sustain
情节=circumstances
刑法=criminal law
从重=severely (punish or sentence)
处罚=punish, punishment
刘德华=Andy Lau
张学友=Jacky Cheung
刘晓庆=Liu Xiaoqing
巩俐=Gong Li
赵薇=Zhao Wei
胡长清=Hu Changqing
最高人民法院=The Supreme People's Court
南昌市=Nanchang Municipality
