定义=definition
语音=pronunciation, speech sound
标准=Standard
方言=dialect
典范=Model, example
现代=modern
白话文=vernacular writing
规范=norm
共同语=common language
文字=script, written language
学术=systematic learning
确定=define, determine
词汇=vocabulary, lexicon, glossary
照搬=mechanically copy，indiscriminately imitate
读音=pronunciation
土音=local pronunciation
连词=Conjunction
异读=variant pronunciation
例如=for example
念=read/pronounce as
推广=promote
通行=be prevailing, current, or universally used
说法=way of expressing, wording
准=standard
吸取=absorb
土语=dialect expression
玉米=corn
棒子=corn
馒头=steamed bun/ steamed bread
馍馍=steamed roll
非=Non
表达力=expressiveness
相应=corresponding
同义词=Synonym
打的=call a taxi
买单=pay the bill (of a meal)
广=wide
书面语=written language
即=i.e.
排除=Exclude, remove
文言文=classical Chinese
形式=form
加工=Process, work, treat
提炼=refine
内地=Inland, hinterland
交往=contact
回归=return
频繁=frequent
恐怖=terror
补救=compensate, remedy
作出=make
观光=sight-see
人士=people, personage
化学=chemistry
端=hold, carry
一下（子)=all of a sudden
往来=interaction, contact
日益=day by day
日常=daily
餐饮=food and beverage
保安=security
行业=trade, industry
偏=deviate from the normal standard
方=side, party
有关=have something to do with, concern
意识=realize
不仅(仅)=not merely
评价=appraisal, evaluation
明显=obviously
之所以=the reason why
普通话=ordinary speech
五四运动=the May 4th Movement
汉=Han Chinese
粤语=Cantonese
香港中文大学=The Chinese University of Hong Kong
地域=area, region
分=divide
北方=north
居住=reside
以下=below, under
沿=along
江=river
除外=leave out, exclude
角=corner
一脉相承=come down from the same origin
朝代=dynasty
首都=capital of a country
逐渐=gradually
通用=commonly use
末年=end of a dynasty
名称=name
国音=standard Chinese pronunciation (an old term)
沿用=continue to use
称说=way of referring, expression
成立=set up, be founded
尊重=respect
避免=avoid, prevent
误解=misunderstand/misunderstanding
召开=hold (meeting), convene
通用语=lingua franca
定名=designate a name
时代=era
确立=establish
具体=specific, concrete
略=slightly
当今=today, presently
仍旧=still
同宗同源=be of the same ancestors
不如=less than, not as good as
明确=clear and definite, explicit
其=its
实质=substance, essence
尚=yet, still
存在=exist
差别=difference
镇江=Zhenjiang city
吴=Wu, ancient name for SW China
上海=Shanghai
江苏=Jiangsu Province
湘=Xiang, simplified name for Hunan
湖南=Hunan Province
长沙=Changsha, capital city of Hunan
赣=simplified name for Jiangxi
总数=total number
总和=sum
相差=differ (in number)
省份=province
特征=feature, characteristic
稀少=scarce
牧区=pastoral area
聚居=live together
执行=perform, carry out, execute
区域=Region
旗=banner (administrative unit in Inner Mongolia, equivalent to county)
具备=have, possess
其余=remaining
祖国=motherland
自治区=autonomous region
习俗=custom, folkway
生活=Life
方式=way, manner
重大=major
乙=second
户=household
奶制品=dairy product
坛=vase
袍=gown
蒙古包=yurt
席地而坐=sit on the floor
迎接=walk up to meet someone, welcome
初一=the 1st day of the month
跨=bestride, straddle
骏马=fine horse
挨个=One by one
荡=swing
村寨=village
小伙子=Lad
竹子=bamboo
立=set something up
秋千=swing
公尺=Meter
同胞=compatriot
围坐=sit in a circle
火锅=hot pot
围炉=sitting around the stove
滴酒不沾=be totally abstinent from alcohol
象征性=symbolic
吉利=good luck; lucky
席位=seat, position
思念=Miss
挂=hang
贴=paste
挂旗=colored papercut of the Man people
图案=logo, design
优美=beautiful
色彩=color, hue
鲜艳=bright, fresh (of color)
吉祥=auspicious
加拿大=Canada
澳大利亚=Australia
扎伊尔=Zaire
赫哲族=Hezhe nationality
珞巴族=Luoba nationality
云南=Yunnan Province
内蒙古=Inner Mongolia Autonomous Region
新疆=Xinjiang Uyghur Autonomous Region
西藏=Tibet Autonomous Region
宁夏=Ningxia Hui Autonomous Region
回族=Hui nationality
广西=Guangxi Zhuang Autonomous Region
壮族=Zhuang nationality
基诺=Jinuo nationality
维吾尔=Uyghur nationality
蒙古族=the Mongolian nationality
哈尼族=the Hani nationality
高山族=the Gaoshan nationality
茶叶=tea leaves, tea
故乡=hometown
悠久=long, remote in time or space
众多=many, numerous
酥油=Tibetan butter
接待=receive
尊贵=distinguished
献=offer, dedicate, present respectfully
敬意=tribute, respect
滤=filter
木桶=wooden barrel
盐=salt
搅拌=stir
融合=fuse, mix together
姑娘茶=tea prepared by a virgin girl
精心=careful, meticulous
赠送=give as gift
亲朋好友=relatives and close friends
订亲=be engaged, be betrothed
信物=keepsake between lovers
纯真=innocent, pure, sincere
爱情=love
碎=broken (into pieces), smashed
核桃=walnut
桂圆=longan
红枣=jujube, red date
冰糖=crystal sugar
混=mix
泡=brew
托=saucer
倒=pour
当面=to someone's face
揭=lift the lid
捧=hold in the palms of both hands
尊敬=respect
独特=unique
道=course (dish, tea)
选取=select
粗=rough, coarse
砂罐=earthern pot
文火=slow fire
烘烤=bake
滚烫=boiling hot
红糖=brown sugar
芝麻=sesame seed
香甜可口=sweet and delicious
意寓=embody the meaning of
苦尽甘来=sweetness comes after bitterness
蜂蜜=honey
粒=tiny piece
花椒=zanthoxylum, black pepper
夹=place in between
丝=shred, trace
麻辣=spicy
回味=savor the flavor
竹筒=a thick bamboo tube
火塘=fireplace
三脚架=tripod
浓郁=rich, thick
穷=end
可谓=can be described as
久远=far back, remote
绚丽多彩=colorful
濒危=be endangered, be in imminent danger
消失=disappear
亚=inferior, second
物种=species
化石=fossil
足够=enough, sufficient
研讨会=seminar, symposium
学者=scholar
真切=genuine, sincere
呼吁=appeal
与会=participate in conferences
全球化=globalization
热烈=warm, enthusiastic, animated
民族学=ethnology
人类学=anthropology
导师=tutor, supervisor
无形=invisible
遗产=heritage
有形=tangible
消亡=be extinct
积累=accumulate, accumulation
传承=pass down, inheritance
流失=lose, drain, deplete
迄今=so far
濒临=be on the verge of
语种=languages
面临=face
迫在眉睫=imminent
种类=kind
研究=research
斑白=gray, grizzled
鬓=temples, hair on the temples
语言学=linguistics
硕士=master
固守=stick to
迅猛=rapid
描写=describe, description
手段=means
挑战=challenge
高新=(of technology) high and new
技术=technology
更新=update
录音=record, recording
录像=videotape, video
软件=software
科技=science and technology
采集=gather, collect, bring together
纪录=record
语料库=corpus, collection of language samples
价值=worth, value
得以=be able to
保存=save, preserve
藏族=Zang (Tibetan) nationality
布依族=Buyi nationality
傣族=Dai nationality
白族=Bai nationality
中国社会科学院=the Chinese Academy of Social Sciences
世界少数民族研究院=the Institute of World Ethnic Minorities
中国民族语言学会=the Society of Chinese Ethnic Minority Languages
孙宏开=Sun Hongkai (Person name)
增=increase
某=some, certain
必然=inevitable
观察=observe,
准确=accurate
作品=works, book, publication
源远流长=go back to ancient times, have long history
民间=among the people, folk
表现=show, manifest
企盼=anxiously expect
鸡子=egg
寓意=embodying the meaning of, signified meaning
巷=lane, alley
密密麻麻=dense
群=crowd
国策=national policy
增长=grow, growth
生育=give birth to
取得=achieve
举世瞩目=attract worldwide attention
育龄=child-bearing age
棘手=stubborn; troublesome
艰巨=arduous
紧密=close, intimate
落实=implement
奖励=award
避孕=take contraceptive measure
节育=control birth
千家万户=tens of thousands of households
机遇=opportunity, favorable circumstance
庞大=Enormous, huge
贯彻=carry out，implement
状况=situation
砍=cut
比比皆是=be everywhere
中叶=middle period
目标=target, goal
落空=fail to realize (a goal)
其次=secondly
剩余=Remainder, surplus
劳力=labor force
接近=approach
不足=less than, insufficient, inadequate
犯罪=commit crime
黑社会=underworld, gangland
案件=criminal case
例证=example, illustration
确保=ensure
隐患=hidden trouble
富=rich
摩天大厦=skyscraper
消耗=consume, consumption
燃烧=burn
匮乏=short of
危机=crisis
自给自足=be self-sufficient
进口=import, importation
倾倒=dump
气体=gas
交织=intertwine
率=rate
老龄化=aging
相关=Relate
赡养=provide for, support
老化=become old
亟=urgent, imperative
爆炸=explode, explosion
实实在在=real, substantial
面前=before, in front of
处理=handle, deal with
严峻=severe, grave
美國之音=Voice of America
詩經=The Book of Songs
普查=census
有识之士=people with insight
忧虑=worry
于是=so
遭到=suffer, encounter, meet with
批判=criticism
口号=slogan
流传=spread, circulate
搁置=shelve, put aside
决策层=decision-maker
局限=limitation
中央级=level of central government
转折点=turning point
降至=drop to (a point)
国民经济=national economy
方针=guiding principle, policy
配合=work with, cooperate
日后=future
埋=bury
伏笔=hint, foreshadowing
响应=respond to
分别=respectively
地方性=local nature or characteristic
公开信=open letter
里程碑=milestone
基本=basic, fundamental
座谈会=forum, symposium, informal discussion
列入=include, list
议题=topic of discussion, agenda
脱贫致富=eliminate poverty and get rich
优质=of good guality
含=contain
文件=file, document
土地=land, field
平方=square
密度=density
平衡=balanced
显著=notable, marked, striking
密集=dense
稀疏=sparse
若=if
划=draw
高度=highly
疏=sparse
格局=pattern
逐步=gradually
必然性=inevitability
合理性=rationality
指出=point out
更加=more
当前=currently, at present
着力=make an effort, work hard
财=wealth
物流=logistics, flow of goods
总体=overall, in general
文章=way of doing something, elbow room
反右=the Anti-rightist Movement
中共中央=the Chinese Communist Party Central Committee
国务院=the State Council (of China)
国家计生委=the State Family Planning Commission
爱辉=Aihui (place name)
腾冲=Tengchong (place name)
吉林=Jilin Province
陕西=Shaanxi Province
幅=used for paintings, photos, cloth, etc.
浮=float, appear
影像=image
乐不可支=very very happy
相会=gather together
丧事=funeral
鬼=ghost
神=god, deity
嘴巴=Mouth
川=river
记载=record
猪=pig
专=especially
胃口=appetite
嗜好=hobby
惊讶=feel greatly surprised
鲨鱼=shark
鳍=fin
燕子=swallow
窝=nest
蛇=snake
龟=turtle
猴=monkey
总结=summarize
凡是=all
五花八门=of great variety
蒸=steam
炸=deep fry
煎=fry in a pan
炖=stew
拌=mix
涮=instant-boil, scald thin slices of meat in boiling water
应有尽有=have everything that one should have
毫=in the least, to the slightest degree
意外=Surprise
吃惊=feel shocked
力气=effort, strength
欺负=bully , pick on sb
吃亏=be disadvantaged, suffer losses
耳光=slap on face
告=sue
官司=lawsuit
紧迫=urgent
吃紧=critical
俗话=common saying
民以食为天=food is the first necessity for people
媳妇=wife, daughter-in-law
油条=long, deep-fried dough stick
惊奇=wonder, amazed
羡慕=admire
眼光=eye, attention
通婚=intermarriage
所谓=so-called
风气=common/established practice
不厌其烦=not mind taking the trouble
增强=enhance
光荣=glorious, honorable
幸亏=luckily, fortunately
裹=wrap, envelop
辈子=whole life
万一=just in case, if by any chance
皇宫=imperial palace
糟=messy, poor, in a bad situation
太监=eunuch
抗议=protest
挖苦=speak sarcastically
婆家=husband's family
娘家=married woman's parents' home
嫁鸡随鸡=put up with a rooster if you marry one
嫁狗随狗=put up with a dog if you marry one
总统=president
夫人=wife, lady
例外=exception
嫂子=elder brother's wife
豆浆=soybean milk
不得了=(as complement) very much
捏=hold between thumb and fingers
一个劲=persistently
噎=choke
蘸=dip in (liquid)
瞟=quickly glance at
不便=not suitable, inappropriate
慈祥=kindly, amiable
公公=husband's father
点头=nod one's head
小叔子=father's younger brother
咀嚼=chew
自觉=aware, conscious
语气=tone, manner of speaking
话音=voice
落地=the talk is just finished
缓缓=slowly, gradually
微=slightly
发颤=quiver
眼圈=eye socket
万分=very much
委屈=wronged
黛比=Debby
耐克=Nike
漫谈=talk informally
享有=joyously possess
盛名=great reputation
味=taste
调和=mediate
菜系=cuisine, style of cooking
烹调=cook
海味=seafood
麻=(of food) producing a burning sensation
舌头=tongue
刺激=stimulate, stimulation
加速=accelerate
循环=circulation
功效=effect
汗=sweat
舒畅=happy, entirely free from worry
海鲜=seafood
龙虾=lobster
海蟹=crabs
蚝油=oyster sauce
点心=dim sum
品尝=taste
各式各样=a variety of
咸=salty
柔和=soft, gentle
受不了=can not stand
早点=breakfast, snack eaten in the morning
咸菜=salted vegetable, pickle
浓烈=thick and strong, rich
食欲=appetite
由来=origin, source
菜肴=cooked dishes
冠=crown with
别具一格=unique
美好=beautiful
联想=imagination, association
增添=add
魅力=charm
典故=allusion
美味=delicious food, delicacy
佳肴=delicacies
色彩=color, flavor, characteristic quality
传奇=legend
饭铺=small restaurant
老板娘=female business owner, shopkeeper's wife
麻子=pockmarks
软=soft
滑=smooth, slippery
酥=crispy
嫩=tender
鲜=fresh
食客=resturant patron, eater
慕名=admire the reputation
名扬天下=be famous in the world
吟诗=chant poems
作赋=compose prose poems
晌午=noon
顿时=immediately
灶=stove
操刀=hold a scalpel or knife--do the cooking
烹=cook
俱=all
佳=good
转眼间=blink of an eye
精光=nothing left
脊背=back of a vertebrate
五颜六色=colorful
丝=thin slices
柳叶=willow leaves
赞成=praise, agree
官银局=government bank
宴请=invite to a banquet
亲手=personally
司厨=do the cooking
鸭=duck
酒坛=wine pot
煨=simmer
醇香=sweet-smelling
令=make, cause
称赞=praise
已=stop
菜谱=recipe
山珍海味=delicacies
调制=season, adjust the flavor of food
更胜一筹=better
青睐=favor
文士=men of letters
香味=fragrance
四溢=overflow
陶醉=feel intoxicated
即兴=impromptuously
吟=recite, chant
荤=meat dish
飘=float in water or in wind
佛=buddha
禅=zen, meditation
齐声=in chorus
叫好=applaud
众口一辞=unanimously
鲁=abbreviated name for Shandong Province
川=abbreviated name for Sichuan Province
粤=abbreviated name for Guangdong Province
淮扬=Huaiyang, a place in Jiangsu Province
湘=abbreviated name for Hunan Province
扬州=Yangzhou, a place in Jiangsu Province
麻婆豆腐=Ma-po tofu
龙凤呈祥=Good luck with Dragon and Phoenix (Chicken with Snake)
游龙戏凤=Swimming Dragon Flirts with Phoenix (Chicken with Fish or Sea Cucumber)
成都=Chengdu, capital of Sichuan Province
万福桥=Bridge of Great Happiness
五柳鱼=Five Willow Fish (Fish with Five Shredded Ingredients)
唐代=Tang Dynasty
杜甫=Du Fu, a famous poet who lived in the Tang Dynasty
绍兴=Shaoxing, a place in Zhejiang Province
竞选=running for public office
纳入=incorporate/bring into
战略=strategy
领导人=leader
锦标赛=Championship
运动员=athlete
犹豫=hesitate
织锦=brocade
头版=front page
头条=headline
标题=title， headline
图文并茂=excellent in both pictures/illustrations and texts
回赠=give somebody a gift in return
颁奖=present award
教练员=coach, trainer
领队=leader of a sports team
临别=be at parting, be just before parting
沉浸=immerse
欢乐=joyous, happy
代表团=Delegation
团长=leader of delegation
悄然=Quietly
身份=status, capacity, identity
惊人=astonishing
接见=meet, receive guest
割断=sever
回应=respond, response
关键=key, critical
了却=settle, solve
夙愿=long-cherished wish
意味深长=having deep meaning, pregnant with meaning
公报=communiqué
称=call, be called
普及=be universalized in, be extensively spread
乡村=village
厂矿=factories and mines
外交=diplomacy
屡屡=repeatedly
目光=eyes, attention
承载=bear, carry
使命=mission
荣誉=honor
项目=item, project
夺得=win, take
金牌=gold medal
冠军=champion
闪亮=shine
追逐=chase, pursue
奥秘=mystery
拥有=own, possess
匹敌=be equal to
金字塔=Pyramid
选拔=select
体系=system
模式=pattern, model
推=push
职业=occupation
联赛=league matches
原先=originally
保留=continue to have, retain
接轨=Connection
赞助=sponsor
资金=fund
注入=inject, invest
正规=formal
青少年=teenagers, adolescent
注冊=register
后备=reserved
选手=contestant ,athlete
从而=thus
单打=singles
掀起=start, begin (a large scale trend)
担当=assume (a job)
职务=position, job
名师出高徒=Famous teachers produce superb students
刻苦=hard, assiduously
运作=operate
开辟=Open
机构=organization
上级=superior, supervisor
委员会=committee
对付=deal with
决赛=finals
出场=enter the arena, participate in competition
获得=win, get
尼克松=Richard Nixon
名古屋=Nagoya, a Japanese city
亚非拉=Asia, Africa, and Latin America
人民大会堂=the Great Hall of the People
周总理=Premier Zhou Enlai
周恩来=Zhou Enlai, China's first premier
首都体育馆=the Capital Stadium
奥运会=the Olympic Games
起源=origin
神话=myth, fairy tale
传说=legend
胜利=victory
竞赛=competition
用以=use to (do something)
祭祀=offer sacrifices to gods/ancestors
打败=defeat
运动会=sports games
盛会=big event, grand meeting
演变=evolve, change
神圣=sacred
庆典=celebration, a ceremony to celebrate
伴=be accompanied by
战事=war
能量=energy
极限=limit
属于=belong to
城镇=cities and towns
征服=conquer
好战=war-craving
凶狠=fierce and malicious
亡命=desperate
格斗=wrestling, fistfighting
取代=replace
转移=shift
统治者=ruler
下令=give orders
拆毁=demolish
竞技场=arena
声称=claim
异教徒=infidel, pagan, heathen
异端=heresy
举办=organize, hold
光辉=brilliance
埋没=bury, shadow
教育家=educationist, educator
社会活动家=social activist
继往开来=carry forward the cause and forge ahead into the future
宪章=charter
洲=continent
开展=carry out, unfold
批准=approve
日程=schedule
奖牌=medal
有别于=differ from
沿袭=continue, follow
田径=track and field
赛艇=rowing
拳击=boxing
皮划艇=canoeing
马术=horsemanship
体操=gymnastics
曲棍球=hockey
手球=handball
举重=weightlifting
柔道=judo
摔跤=wrestling
羽毛球=badminton
垒球=softball
现代五项=modern pentathlon
击剑=fencing
铁人三项=triathlon
射箭=archery
帆船=sailing
跆拳道=taekwondo
冰球=ice hockey
滑冰=skating
雪橇=sleding
现代冬季五项=modern winter pentathlon
宙斯=Zeus
赫拉克雷斯=Hercules
奥林匹克=Olympic
伊利斯王=King of Elis
奥格亚史=Augeas
罗马帝国=Roman Empire
皮埃尔.顾拜旦=Pierre de Coubertin
雅典=Athens
希腊=Greece
罗马=Rome
菲奥多西斯一世=Theodosius I
国际业余田径联合会=the International Amateur Athletic Federation
奥委会=IOC
夏季奥运会=Summer Olympics
冬季奥运会=Winter Olympics
亚特兰大=Atlanta
悉尼=Sydney
