半=half
操场=sports ground, drill field
差=be short of
吃=eat
上床=go to bed
起床=get up
从…到…=from…to…
到…去=go to (place)
得=need to; have to
点=o'clock
商店=store (n.)
店=store; shop
东西=thing
锻炼=work out, exercise (v.)
一会儿=moment
空儿=free time
午饭=lunch
晚饭=dinner
早饭=breakfast
分=minute
过=pass (v.)
好=OK (indicating approval)
集合=gather, assemble
以后=after
然后=then
开会=attend, hold a meeting
时间=time
见=see, meet
教室=classroom
节=period, session
睡觉=sleep (v.)
开始=begin, start
刻=quarter (of an hour)
上课=have class
课=class
下课=finish class
来=come
买=buy
每天=everyday
噢=oh
一起=together
以前=before
去=go
晚上=evening
上午=morning
早上=in the morning
食堂=dining hall
喂=hello, hey
中午=noon
下午=afternoon
学习=study (n./v.)
先=first; in advance
现在=now
想=want to; would like to
一些=some
行=be all right
作业=homework
钟=clock; time ( as measured in hours and minutes)
走=go, leave
做=do, make
吧=(indicating suggestion or doubt)
本=(measure word)
才=later than expected
常（常）=often; frequently
词典=dictionary
打算=intend; plan (v.)
电影=movie
电视=television
一块儿=together
上 (个)=last (month; week)
下(个）=next
图书馆=library
体育馆=gym
英汉=English-Chinese (dictionary)
号=date; number
时候=time; moment
回=go back
几=several; how many
借=borrow (v.)
今天=today
最近=recently
就=as early as; earlier than expected
快乐=happy
礼物=gift
日历=calendar
忙=busy
咱们=we (including the listener)
明天=tomorrow
明年=next year
新年=year
去年=last year
年=year
星期天=Sunday
星期=week
生日=birthday
日=date
宿舍=dormitory
书=book
送=give
昨天=yesterday
学=study (v.)
月=month
祝=wish (v.)
比=…than… (comparison)
差不多=almost; nearly
大部分=most of
经常=often; constantly
春天=spring
觉得=feel; think
最低=lowest
一定=must; certainly
冬天=winter
度=degree
刮风=windy
高=high; tall
跟…一样=as/same…as…
习惯=get used to
暖和=warm
有时侯=sometimes
气候=climate
华氏=Fahrenheit
滑雪=ski (v.)
喜欢=like; love
季节=season
一年四季=all year round (four seasons) the year
家乡=hometown
可以=able to
可是=but; however
凉快=cool
蒙特雷=Monterey
冷=cold
为什么=why
那么=then; in that case; like that
气温=temperature
天气=weather
晴天=clear day
重庆=name of a city
秋天=autumn
热=hot
少=few; little; less
摄氏=Celsius, centigrade
总是=always
所以=so; therefore
太=extremely; too
阴天=overcast; cloudy day
夏天=summer
因为=because
下雾=foggy
下雨=rain (v.)
下雪=snow (v.)
游泳=swim
用=use; apply
左右=about; more or less
真=really; truly
最=(superlative markers)
平均=average; equally
海边=seaside
跑步=run (v.)
散步=go for a walk
多长=how long
长城=Great Wall
汽车=automobile
自行车=bicycle
开车=drive (car, bus, train)
公共汽车=bus
火车=train (n.)
打(排球)=play (volleyball)
大家=all; everybody
有的=some
地铁=subway
电影院=movie theatre
书店=bookstore
活动=activity
多久=how long (time)
饭馆=restaurant
风景=scenery
王府井=Wangfujing Boulevard
复习=review (lesson) (v.)
高兴=happy; glad
功课=homework
逛=go window-shopping
过=particle used after a verb indicating past experience
过=spend; pass ( time)
海滩=beach
好主意=that's a good idea!
或是=or
已经=already
烤=roast (v.)
愉快=happy; joyful
周末=weekend
那=in that case; then
星期日=Sunday
骑=ride (v.)
肉=meat
沙滩=sandy beach
晒太阳=sunbath (v.)
小时=hour
要是=if
钟头=hour
玩=play
休息=rest (n./v.)
需要=need; require
晒太阳=sunbath (v.)
自由=free
坐=sit; aboard (bus, train)
帮忙=help (v.)
比较=relatively; comparatively
便宜=cheap; inexpensive
方便=convenient
参加=join
长途=long distance (call, trip)
校车=school bus
城=city
出发=leave; depart
春节=Spring Festival
下次=next time
打(电话)=make (phone call)
大约=approximately
看到=catch sight of; see
外地=out of town
订=book (tickets, seats)
华盛顿=Washington
放假=have a vacation
飞机=airplane
舒服=comfortable
附近=nearby; close to
告诉=tell
给=give; for; to
公里=kilometer
黄石公园=Yellowstone Park
古迹=historical site
旅馆=hotel
如果=if
杭州=Huangzhou
红=red
计划=plan; plan (v./n.)
极=extremely
价钱=price
暑假=summer vacation
郊外=suburbs; outskirts
景色=scene; landscape
快=fast
游览=go sightseeing; visit
累=tired
路上=on the way
旅游=tour (n./v.)
旅行团=tourist group
旅行=travel (v.)
旅行社=travel agency
美=beautiful
名胜=famous scenic spots
爬山=climb (mountain)
票=ticket
香山=Fragrant Hill
网上=on the Internet
听说=be told; to hear of
苏州=Suzhou
外=outside
叶=leaf
又…又…=both…and…
远=far; remote
