把=measure word (chair, toothbrush)
白=white
百货大楼=department store
百货=general merchandise
书包=backpack
杯子=cup
笔记本=notebook
圆珠笔=ballpoint pen
铅笔=pencil
别的=else
全部=all; whole
除了…以外=in addition to; except
打六折=40% off
打折=give a discount
大楼=building(multi-stories)
领带=tie
运动=sports; athletics
运动鞋=sports footwear; sneakers
儿童=children
咖啡(色)=brown (color)
肥皂=soap
服装=clothing
牙膏=toothpaste
广告=advertisement
一共=altogether
贵=expensive
请收好=please, keep it; hold it
请拿好=please, keep it
黑=black
还=also; still
黄=yellow
加上=add (v.)
加=add; plus (v.)
夹克=jacket
降价=sell at a reduced price
毛巾=towel
收据=receipt
裤子=pants
块=basic unit of money (equal to ten mao)
蓝=blue
质量=quality
绿=green
毛=basic unit of money
拿=take; hold (v.)
能=can, be able to
皮鞋=leather shoes
钱=money
颜色=color
式=style
牙刷=toothbrush
套=measure word (set of suit, tea set)
条=measure word (towels, pants, tie, fish)
筒=measure word for toothpaste
西装=western-style suit
休闲=casual
鞋=shoes
要=want; ask for (v.)
找=give (change) (v.)
枝=measure word for a pen
种=type, sort, kind
把=measure word (handful of rice, certain vegetables)
帮=help (v.)
菠菜=spinach
不错=not bad, OK
不但…而且=not only…but also
不过=but
蔬菜=vegetable
农贸市场=farmers' market
市场=market
衬衫=shirt
称=weigh
小吃=snack, refreshments
穿=wear; put on (v.)
串=bunch, cluster
大概=maybe, perhaps
地方=place (n.)
衣服=clothing, clothes
价格=price
西瓜=watermelon
苹果=apple
水果=fruit
号=size (n.)
合适=fit; suitable
西紅柿=tomato
鲜花=fresh flower
售货员=salesperson
件=measure word (shirt, luggage)
交=hand in
香蕉=banana
斤=unit of weight
近=near, close
桔子=orange (fruit)
离=from; off
卖=sell (v.)
毛衣=sweater
其他=other, else
试(试)=try on (v.)
摊=vendor's stand; stall
摊主=peddler; stall keeper
挑=select, pick (v.)
新鲜=fresh
再=again, more
整=whole, complete; exact
正=just
主=owner; host
包=wrap
杯=cup; glass (M)
准备=prepare
一边…一边=at the same time
菜单=menu
点菜=order dishes
餐巾=napkin
餐具=tableware
餐巾纸=napkins
刀叉=knife and fork
绿茶=green tea
家常豆腐=special fried tofu
炒=stir-fry; fry
青椒炒牛肉=beef with green peppers
次=frequency of time
糖醋鱼=sweet and sour fish
醋=vinegar
带=bring
录像带=videotape
蛋=egg
鸡蛋汤=egg drop soup
…的时候=when; the moment
等一下=wait a second
豆腐=tofu
米饭=rice
服务员=attendant
跟=follow
跟我来=follow me
罐=jar; tin (M.)
喝=drink (v.)
壶=kettle (M.)
会=be able to; be good at
鸡=chicken
青椒=green pepper
饺子=dumplings
啤酒=beer
聚聚=get together
可乐=cola, coke
筷子=chopsticks
辣=spicy
倆=two (people)
聊天=chat
饮料=beverages
另外=another; other (adj.)
请慢用=please enjoy one's meal
牛肉=beef
盘=tape (cassette) (M.)
盘子=plate
瓶=bottle (M.)
汽水=soda
请=invite; ask
让=let
稍=a little; slightly
勺子=spoon
事=matter; thing
汤=soup
糖=sugar
甜=sweet
挺=very; quite
通知=inform; notify
完=finish; be over
碗=bowl
照相=take pictures
一直=continuously; all the way
鱼=fish (n.)
员=a person engaged in some
汁=juice
纸=paper
摆=set; arrange (v.)
班=work; shift
下班=get off work
右边=right side
里边=inside
前边=front side
左边=left side
后边=behind
旁边=side
餐桌=dining table
层=floor; layer
非常=very; extremely
车库=garage
厨房=kitchen
床头柜=nightstand
双人床=double bed
单人床=single bed
地下=underground
地下室=basement
对面=face to face; opposite
沙发=sofa
房子=house
书房=study room
房租=rental fee
放=put (v.)
咖啡桌=coffee table
付=pay (v.)
应该=should
公寓=apartment
碗柜=cupboard
柜=cabinet
花园=garden
还可以=pretty good; not bad
家具=furniture
书架=bookshelf
卫生间=bathroom
中间=among; between; middle
洗澡间=bathroom
押金=deposit
经理=manager
棵=measure word for tree(s)
客厅=living room
听起来=it sounds
漂亮=beautiful
另=other; another
楼=storied building; floor
室=room
卧室=bedroom
树=tree
洗澡=take a bath
椅子=chair
院子=yard
种=plant; grow (v.)
着=continuous aspect marker
租=rent (v.)
天安门广场=Tiananmen Square
长安街=Chang'an Street
酒吧=bar
人民币=Renminbi
标准间=standard room
餐厅=dining room, restaurant
查=check (v.)
查一下=check
机场=airport
火车站=railway station
游泳池=swimming pool
池=pool
钥匙=key
出=go out; outward movement (v.)
等=and so on, etc.
第=prefix for ordinal numbers
旅游点=tourist spot
点=spot
电梯=elevator
饭店=hotel
多种=various types
房间=room
健身房=gym
咖啡厅=cafe
咖啡=coffee
费=fee, cost
十分=extremely, exceptionally
服务=service; serve (v.)
服务台=reception desk
交通=transportation
街=street;
结=settle (v.)
结帐=pay the bill
现金=cash
进=move forward; enter
信用卡=credit card
卡=card
客=guest; visitor
游客=tourist
马上=immediately; at once
支票=check
签字=to sign; signature
签=sign (v.)
上=go up; get on (v.)
设施=facilities; equipment
市中心=downtown
收=accept (v.)
厅=hall
退=return (v.)
下=descend; get off (v.)
信用=credit
之一=one of
预=in advance, beforehand
帐=debt; accounts
之=of
字=word; character
市场=market
超级市场=supermarket
呆=stay (v.)
干=do (v.)
购物中心=shopping center
购物=shopping
购=purchase; buy (v.)
豪华=luxury
只好=have to
好久=for a long time
文具=stationery
作客=be a guest
累=tired
日用品=commodity; necessity
裙子=skirt
有意思=interesting; fun
物=thing; matter
中心=center
