办理=handle; conduct
本=this, current
特快(特别快车)=express train
不客气=don't mention it
餐车=dining car
列车=train (n.)
车厢=compartment
候车室=waiting room (railway/bus station)
发车=depart
乘坐=ride (on a train, bus) (v.)
处=place
窗口=window gate; ticket window
次=train number
到达=arrive; reach
过道=passageway
登机口=boarding gate
登机=boarding an airplane
护照=passport
欢迎=welcome
机票=passenger ticket
交运=check (luggage)
开往=be bound for
靠=close to; near
行李=luggage, baggage
牌=plate, sign
卧铺=sleeping berth
铺=bunk, sleeping berth
亲友=relatives and friends
软卧=soft sleeper
随身=(take) with one
手续=procedure
趟=for a trip
趟=measure word (denotes frequency of trips)
托运=check (luggage)
为=for
硬卧=hard sleeper
比=ratio; to (in a score)
外币=foreign currency
随便=do as one pleases
表=form; chart
不仅…而且…=not only… but also…
不同=different
商场=market; bazaar
成=become; turn into
游船=pleasure boat
船=boat
存=deposit (v.)
存折=deposit book
存款=deposit; bank savings
单=form; list (n.)
简单=simple
知道=know
点=decimal point
点=count (money) one by one
定期=fixed deposit
自动=automatic
自动提款机=ATM machine
兑换=exchange; convert
许多=many
身份=status; identity
身份证=ID card
账户=account (n.)
换=exchange; change (v.)
活期=current deposit
机=machine
开=open (v.)
提款=draw (money/cash)
款=a sum of money; funds
越来越…=more and more …
利息=interest (on a loan)
率=rate; ratio
怎么=how
美元=U.S. dollar
提取=withdraw; pick up
取=get; withdraw
上=on
甚至=even (conj.)
随时=at any time
填=fill in
证=certificate; card
总之=in short
帮助=help; assist
包裹=package; parcel
保价=insurance
报纸=newspaper
编码=code
进步=progress; advance
超=exceed; surpass
超重=overweight
称=weigh
回答=answer; response (n.)
单子=form; list, bill
当中=among; in the middle
地址=address (n.)
递=hand over; pass
特快专递=express mail
海淀区=Haidian District
懂=understand
语法=grammar
邮费=postage
份=measure word for newspaper
信封=envelope
封=measure word for letter
挂号=register (v.)
挂号信=registered mail
光盘=compact disk
航空信=airmail
航空=aviation
互相=mutual; each other
回执=return receipt
生活=life
寄=send; mail
讲=say; tell; speak
讲课=teach; give a lesson
紧张=tense; nervous
克=gram
音乐=music
努力=make great efforts
学院路=Xueyuan Road
邮票=stamp
平信=surface mail
普通=regular; ordinary
学期=term; semester
区=district; area
收=receive
问题=question
贴=stick; glue
听=hear; listen
箱=box; chest
信箱=mailbox; postal box
写=write
信=letter
邮政=postal service
杂志=magazine
重=heavy; weighty
字=character; word
按时=on time
一般=general; common
遍=measure word (frequency of an action)
别=don't
病人=patient
病历=medical records
病=illness; sickness
看病=see a doctor
不用=need not
不用谢=don't mention it
检查=checkup; examine
清楚=clear (v.)
从…起=since; from
打针=give or have an injection
担心=worry; feel anxious
得=get; take; catch (disease)
肚子=belly; tummy
拉肚子=suffer from diarrhea
发烧=has a fever
开药(方)=write out a prescription
药方=prescription
药房=pharmacy; drugstore
肺炎=pneumonia
感冒=catch cold
流感=flu
感觉=feel; feeling
挂号证=registration card
挂号=register (at a hospital)
厉害=severe; sharp
最好=had better
护士=nurse (n.)
急诊室=emergency room
开=make a list of; write out
内科=department of internal medicine
科=department (in hospital)
咳嗽=cough (v., n.)
门诊室=outpatient room
门诊=outpatient service
内=internal; inside
片=tablets, pills
嗓子=throat
烧=run a fever; fever
医生=doctor
透视=X-ray
诊室=consulting room
头疼=headache
疼=ache; pain; sore
体温=body temperature
头=head (n.)
忘=forget
以为=think; believe
心脏=heart
血压=blood pressure
药=medicine; drug
医院=hospital
安全=security
按=according to
巴士=bus
机场巴士=airbus
航班=flight; flight number
左手边=left-hand side
标志=sign; symbol
步=step; pace
部=division; department
小卖部=small shop
(船）尾部=stern of a boat; end part
二等舱=second-class cabin
舱=cabin
路(汽车)=route; bus No.
出租(汽)车=taxi (n.)
乘警=policeman (on a train or boat)
大道=boulevard; avenue
大使馆=embassy
大厅=hall
找到=find
道=road; way; route
红绿灯=traffic light
灯=light; lamp
底=bottom; end
首都=capital
返=return (v.)
往返=round-trip
管理建设费=construction fee
各=each; all; various
拐=turn (v.)
海关=customs
管理=management
国内=domestic; internal
国际=international
建国门=Jianguomen
国旗=national flag
过=cross; pass (v.)
经过=go through; pass
候=wait; await
候机楼=airport waiting building
(欢)迎客(人)=welcoming guests
劳驾=Excuse me; May I trouble you?
建设=construction
立交桥=overpass
接=meet; receive
客运室=passenger office
十字路口=four-way intersection
路口=intersection
马路=road; avenue
面=measure word for flag
牌子=plate; sign; ticket
铺位=bunk; berth
旗=flag; banner
桥=bridge (n.)
设=set up; establish
医务室=clinic
手=hand (n.)
停=stop; pause (v.)
尾=tail; end
向=towards
沿=along
找=look for; seek
至=to; till; until
座=measure word for overpass; bridge
值班=on duty
厕所=lavatory, toilet
救护车=ambulance
排队=stand in line
麻烦=trouble; bother (v., n.)
救护=rescue
化验室=laboratory
化验=lab test
浑身=from head to toe; all over
急性=acute
自己=oneself
辆=measure word for vehicle
没问题=no problem
签证=visa
血=blood
验血=blood test
验=examine; test
