公元=the Christian era
平原=plain; flatland
雨伞=umbrella
探险=expedition; explorations
有……之称=be known as…
亲自=in person; do something by oneself
漫长=very long; endless
类型=type; kind
植物=plants
山峰=mountain peak
丘陵=hills
盆地=basin
海岸线=coastline; shoreline
流域=river valley
古代=ancient times
错误=mistake; error
上游=upper reaches of a river
中游=middle reaches; midstream
下游=lower reaches; downstream
源流=source and course of a river
难道=Is it possible that…?
山脉=mountain range
限制=limit; restrict; restriction
真正=genuine; true; real
发源地=place of origin; source
发源=originate; rise
确认=confirm; confirmation
高原=plateau
石灰岩=limestone
地形=topography; landform
位置=location; site; position
一带=area; region; district
岩=rock
洞=hole; cavity
整理=put in order; sort out; arrange; straighten out
著作=work; book; writings
顶=for a hat
明珠=bright pearl
地貌=topographic feature
行=go
装=dress; outfit; attire; clothing
松树=pine tree
导游=guide; tour guide
天下=land under heaven; China
归来=return; come back
哪怕=even; even if; even though; no matter
咸水湖=saltwater lake
鸟=bird
岛=island
欣赏=enjoy; admire
迷人=enchanting; charming
人间=the human world; the world
天堂=paradise; heaven
上有天堂，下有苏杭=Above, there is heaven; below，there is Suzhou and Hangzhou
把……比作=compare…to
印象=impression
深=deep; profound; dark (color)
沙漠=desert
草原=grasslands; prairie
风光=scene; view
原始=primitive; original
森林=forest
依我看=in my opinion; it seems to me
以……划分=be divided into…by
桂林山水甲天下=Guilin has the best scenery in the world
观赏=enjoy the sight of; view
武功=military accomplishments; martial art; acrobatic skill
月色=moonlight
不妨=there is no harm in; might as well
位于=be located; be situated
海拔=height above sea level
内陆=inland; interior
淡水=fresh water
石油=petroleum; oil
天然气=natural gas; gas
天然=natural; native
铜=copper
铁=iron
矿产=mineral products; minerals
银=silver
镜子=mirror
美丽=beautiful
牧场=livestock farm; ranch
羊=sheep; goat
打仗=fight; go to war; make war
葡萄=grape
薄=thin; flimsy
奶酪=cheese
帐篷=tent
养=support; provide for
念书=read; study; attend school
野生=wild; uncultivated
心爱=love; treasure
钻石=diamond
戒指=ring
憨厚=simple and honest;
面=for a mirror or flag
颗=for a gem or tooth
只=for a hand, sheep, or chicken
湖泊=lake
好似=seem; be like
宝石=gem; precious stone
辽阔=vast; extensive
行驶=(of a vehicle) go; travel
游牧=move about in search of pasture; nomadic
徐霞客=name of a person
太湖=a lake in Jiangsu Province
岷江=a river in Sichuan Province
长江=the Yangtze River, the longest river in hina
黄河=the Yellow River, second longest river in China
金沙江=an upper reach of Yangtze River
青藏高原=Qinghai-Tibet Plateau
唐古拉山=A mountain in Tibet
黄山=a mountain in Anhui Province
泰山=a mountain in Shandong Province
庐山=a mountain in Jiangxi Province
少林寺=a Buddhist temple in Henan
青海湖=a salt lake in Qinghai
西湖=West Lake, a lake in Hangzhou
三峡=the Three Gorges on the upper and middle reaches of the Yangtze River
秦岭=a big mountain in northwest China
淮河=a river in central China
乌鲁木齐=capital of Xinjiang
塔克拉玛干=a desert in Xinjiang
天池=a lake in Xinjiang
天山=a mountain in Xinjiang
艾丁湖=a lake in Xinjiang
吐鲁番=an area in the middle eastern part of Xinjiang
哈密=a city in east Xinjiang
伊犁=a region in northwest Xinjiang
清朝=the Qing Dynasty
夏令营=summer camp
猜=guess
答案=answer key
近海=coastal waters
领水=offshore territorial waters
陆地=dry land; land
行政区=administrative region or area
行政区划=administrative division
省会=provincial capital
级别=rank; level
县=county
乡=township
管辖=have jurisdiction over
说明=explain; illustrate; show
意思=meaning; idea;opinion; wish; desire; suggestion; interest
少数=minority
民族=nationality
占=constitute; account for; occupy; seize; take up
领导=lead; exercise；leadership; guide; leadership; leader
担任=hold the post of
州=prefecture
热带=tropics
雨林=rain forest
象征=symbol
简称=shorter form name; abbreviation
任何=any; whatever
亿=a hundred million
公民=citizen
听众=listeners; audience
关注=follow with interest
婴儿=infant; baby
产妇=new mother; woman who has just given birth
计划生育=birth control; family planning
委员会=committee
角度=angle
提倡=advocate
增长=increase
增加=increase; raise; add
否则=otherwise
分布=distribution
沿海=along the coast
闹市区=busy downtown area
迁移=migrate; move
绝大多数=overwhelming majority
边疆=border area
成长=grow up; grow to maturity; adolescence
城市群=greater metropolitan area
办事处=office; agency
商人=businessman
投资=invest; investment
董事会=board of directors
心得=what one has learned from work; study, etc.
形成=form; take shape; shape; formation; production
经济圈=economic circle
动力=driving force; power
意义=meaning; sense; significance
三角洲=delta
港口=port; harbor
进口=import
出口=export
贸易=trade
额=volume; a specified number or amount
稠密=dense
消费=consume; consumption
水准=level; standard
高速=high speed; swift; fast; express
水运=water transport
活跃=brisk; active; dynamic; enliven; animate
国内总产值=gross domestic product (GDP)
集中=concentrate
海湾=gulf; bay; loch
煤炭=coal
原油=crude oil
物资=goods and materials
转运站=transit hub; transfer post
实际上=in fact; in reality; actually
新加坡=Singapore
三亚=a city in Hainan Province
澳门=Macao
海口=the capital city of Hainan Province
黎族=the Li nationality
定安县=a county in Hainan Province
南丽湖=Nanli Lake in Hainan Province
五指山=the name of both a mountain and a city in Hainan Province
海南岛=Hainan Island
毛阳镇=a town in Hainan Province
琼=short name for Hainan Province
粤=short name for Guangdong Province
汉族=the Han nationality
壮族=the Zhuang nationality
满族=the Man nationality
回族=the Hui nationality
珠江三角洲=Pearl River Delta
深圳=a city in Guangdong Province
东莞=a city in Guangdong Province
佛山=a city in Guangdong Province
珠海=a city in Guangdong Province
长江三角洲=Yangtze River Delta
昆山=a city in Jiangsu Province
宁波=a city in Zhejiang Province
渤海湾=Bohai Bay
沈阳=the capital city of Liaoning Province
台北=Taipei
经济学=economics
轻工业=light industry
工业=industry
首先=first; first of all
密切=intimate; close; closely; build close relations
纺织=weave (textiles)
家用=household; domestic
电器=electrical appliances
行业=trade; profession; industry
产品=product
产量=output; yield; turnout
位居=to be at; occupy (a position)
前列=front row; forward rank(s); forefront
使用=use; make use of; employ
滿足=satisfy
商品=commodity; goods
节省=economize; save; cut down
零售=retail; sell retail
人均=per capita; per person
拥有=possess; have; own
相当于=amount to
调查=investigate; inquiry; survey
户=household; family
零部件=parts; components（零件和部件的合称）
发电=generate electricity
核电站=nuclear power station
航天=space flight
军用=military; for military use
民用=civil; for civil use
商业=commerce; trade; business
载=load; carry; hold
飞船=spaceship
闻名=well-known
作陪=be invited along with the guest; help entertain the guest of honor
吨=ton
山顶=mountain summit; top of a mountain
哆嗦=tremble; shiver
描述=describe; description
顺口溜=doggerel; jingle
井=well
傍晚=at dusk; toward evening
炊烟=smoke from kitchen chimneys
砍=cut; chop; hack
柴=firewood
香喷喷=savory; appetizing
提起=speak of; mention
折腾=toss about; cause physical or mental suffering; do something over and over again
农作物=crop; cultivated plants
荒坡=a barren hill
旱季=drought; dry season
桶=barrel; bucket; tub
唯一=single; only
熬=endure; go through
山泉=mountain spring
自来水=running water; tap water
自费=at one's own expense
农业=agriculture; farming
培育=cultivate; nurture; breed
项=item
收获=gather in the crops; harvest; gains; results
拖拉机=tractor
卡车=truck; pick-up truck
收购=purchase; buy
有线电视=cable TV
抽水马桶=flush toilet
浓=dense; thick; (of degree) great; strong
时分=time
青=blue or green
瓦=tile
金桔/金橘=kumquat (a fruit)
蜂窝煤炉=honeycomb briquette stove
封山造林=closing hillsides to facilitate forestation (封：封闭 造：制造)
俱全=complete in all varieties
马桶=commode; toilet bowl; chamber pot
清香=delicate fragrance; pleasant smell
缕=wisp; strand; lock (of hair)
亩=unit of land measure (= 0.0667 hectares)
户=for household; family
铁路=railway; railroad
网民=net user; netizen
对话=have a dialog or conversation; dialog; conversation; talk
有幸=be lucky to; have the good fortune to
广大=vast; expansive
屋脊=ridge (of a roof)
伟大=great; mighty
线路=circuit; line; route
地段=sector or section of an area
泥石流=mud-rock flow
冻土=frozen soil
运行=move; run; be in motion
修建=build; construct; erect
氧气=oxygen
氧气瓶=oxygen cylinder; oxygen tank
采取=adopt; carry out (measures/policies)
可靠=reliable; dependable
运营=(of buses, ships, etc.) be in operation; open for service; put into operation
纳税=pay taxes; pay duty
人力=manpower; manual labor
物力=material resources
效益=beneficial result; effectiveness; benefit
巨大=(of scale, amount) huge
全天候=all-weather
快捷=fast (speed); nimble
运输=transport; transit
通道=thoroughfare; passageway
供=provide
进展=make progress; make headway; progress
媲美=compare favorably with
摩根斯坦利=Morgan Stanley, an investment bank in the United States
神舟六号=Shenzhou-6; name of a manned spaceship
罗家坡=name of a mountain village
余庆县=Yuqing County
青藏铁路=Qinghai-Tibet Railroa
格尔木=a city in Qinghai Province
拉萨=Lhasa, capital of the Tibet Autonomous Region
央视国际=CCTV International Channel
季风=monsoon
干燥=dry; arid; dull
海洋=seas and oceans; ocean
凉=cool; cold; discouraged; disappointed
分明=clear; distinct; obviously
潮湿=damp; moist; dampness
连续不断=continue; continuous; ceaseless
生长=grow; grow up
小麦=wheat
面食=cooked wheaten food
鱼米之乡=land of fish and rice; a land of plenty
查看=check; examine
闷热=hot and stifling; sultry
特色=salient feature; distinguishing quality
灾害=disaster; damage
霜冻=frost
风力=wind-force; wind power
沙尘暴=sandstorm
台风=typhoon; hurricane
暴风雨=rainstorm; storm; blizzard
洪涝=flood
温差=differences in temperature
阳光=sunlight; sunshine
至于=as for; as to; as regards
难以=hard to; difficult to
冰箱=ice box; refrigerator
棉袄=cotton-padded (or quilted) jacket
梅雨=plum rains
湿润=moist; humidification
晴空万里=a clear and boundless sky
首府=the capital of an autonomous region or prefecture
引发=initiate; trigger; touch off
登陆=land
秒=second
厘米=centimeter
山体滑坡=landslide; landslip
滑坡=hill creep; landslide
临时=temporary; provisional
封闭=seal (up); block; close (down)
袭击=surprise attack; raid
堤防=dike; embankment
水电站=hydroelectric power station
损坏=damage (of objects); break down
失踪=disappear; be missing
遇难=die in an accident; be murdered
毁坏=damage; ruin; sabotage
倒塌=collapse; cave in
毫米=millimeter
淹没=submerge; flood
围困=besiege; hem in; pin down
程度=level; degree
转移=shift; transfer
经费=expense; appropriation; funds
抢险=rush to rescue
河流=river; stream
使得=cause; render; usable; workable
抵御=resist; withstand; ward off
大自然=nature
减低=reduce; lower; bring down
减少=reduce; decrease
加重=increase the weight of; aggravate
现象=phenomenon; appearance
人类=mankind
共同=common; mutual; joint
行走=walk; go on foot
国道=state highway
路基=roadbed; substructure
滞留=be stopped; be detained; be held up
地震=earthquake
震级=earthquake magnitude
震中=epicenter
震感=earthquake felt
地震带=seismic belt
直接=direct; immediate
秩序=order; sequence
维修=maintain and repair
加固=reinforce; consolidate; strengthen
或者=or; perhaps
投亲靠友=go and live (or seek refuge) with relatives or friends (投:投奔; 靠: 依靠)
数字=figure; number; quantity; digital
世纪=century
范围=scope; limits; extent; boundary
波及=spread to; involve; affect
国土=territory; land
惨重=heavy; grievous; disastrous
可想而知=one can well imagine
仪器=instrument; apparatus
救援=rescue; support; help
慌乱=flustered; alarmed and bewildered
逃跑=run away; flee; escape
躲避=hide (oneself); avoid; elude; dodge
砸=pound; tamp; smash; fail
晃动=rock; sway
强烈=strong; powerful; violent
自我=self; oneself; ego
墙角=corner of wall
空间=space; open air; dimension
就近=(get something) nearby; close at hand
生存=exist; live; survive; survival
建筑物=building; structure; shelter
救助=help someone in danger or difficulty
地带=region; zone; belt
邻里=neighbors; neighborhood
环=surround; encircle; ring; hoop; circle
海域=sea area; maritime space
墙根=foot of a wall
江南=a region in the lower Yangtze River valley
四川盆地=Sichuan Basin
泰利(台风名)=Typhoon Tali
临安市=a city in Zhejiang
昌化=a town in Lin'an, Zhejiang
八里河=a river close to Jiujiang city
九江=a city in Jiangxi
岳西=a place in Anhui
中国科学院=Chinese Academy of Sciences;
里氏=Richter earthquake scale
太平洋=Pacific Ocean
地中海=Mediterranean
喜马拉雅山=Himalayas
唐山=a city in Hebei Province
环保=environmental protection
事业=cause; career
宣布=declare; proclaim; announce
公顷=hectare
覆盖率=rate of coverage
到底=(in a question for emphasis) on earth; after all; at last; finally
空气=air
灰尘=dust
窗=window
故事=Story
红松=Korean pine
采伐=fell (timber)
剩下=be left (over); remain
模范=an exemplary person or thing
荒山秃岭=barren mountains and hills (荒: 荒凉)
惭愧=be ashamed
债=debt
还=give back; return; repay
从此=from now/then on; henceforth
补栽=replant
关爱=love and take care of （关心和爱护）
乐趣=delight; pleasure
入列=be listed in
污染=pollution; pollute
市长=mayor
道歉=apologize; make an apology
预报=forecast
公布=announce; publish; make public
钢铁=iron and steel
布局=distribution；layout
合理=reasonable; rational
排放=discharge
况且=moreover; besides
难免=hard to avoid; be booked for
烟尘=smoke and dust
煤矿=coal mine
锅炉=boiler
废气=exhaust gas
尾气=automobile exhaust
检测=check; test
不许=not allow; must not
发表=publish; issue
治理=treat; bring under control
会议=meeting; conference
不再=no longer
热心=enthusiastic; warmhearted
回收=retrieve; recover
扔掉=throw away
浪费=waste; squander; be extravagant
箱子=chest; box; case; trunk, etc.
易拉罐=pop-top can
冰淇淋=ice cream
舍不得=not willing to part with
一次性=one time; disposable
水土流失=loss of water and soil erosion
流失=be washed away
恶化=worsen; deteriorate
成本=cost
数量=quantity
上升=rise; go up
留言=leave a message; message
塑料=plastics
袋=bag
饭盒=lunch-box; dinner pail
似乎=as if; seemingly
值钱=costly; valuable
着想=consider
同一=same; identical
伊春=a city in Heilongjiang Province
焦作=a city in Henan Province
韩国=the Republic of Korea
坝=dam
神秘=mysterious; mystical
畅通=unimpeded; unblocked
民航=civil aviation
协调=coordinate; concert; harmonize
遍布=be found everywhere; spread all over
和平=peace
时期=period
战备=war preparedness; combat readiness
应对=respond; deal with; reply; answer
事件=event; incident
举=cite; enumerate
例子=example
抗击=resist; beat back
突然=sudden; suddenly
下达=make known; transmit to lower levels
命令=order (v./n.); command
立方米=cubic meter
面具=mask
防护=protect; shelter
装备=equip; fit out; equipment; outfit
赛跑=race
告急=report an emergency; be in a state of emergency
保卫=defend
起动=start (a machine etc.)
摩托=motor; motorcycle
专用=special use; for a special purpose
歼击机=fighter plane; fighter
降落=land; descend
备用=reserve; spare; standby application
状态=status; state; condition; state of affairs
目的=purpose; aim; goal
运送=transport; ship; convey
兵员=soldiers; troops
演练=drill
火速=at top speed
发货=send out goods; deliver goods
分局=branch bureau/office
装载=load
被服=bedding and clothing
防毒=protect against poisonous substances
前线=frontline; front
军列=military train
神兵天降=(soldiers coming to the rescue out of nowhere)
士兵=rank-and-file soldiers; privates
船艇=boat; ship; vessel; yacht
桥梁=bridge; approach
建造=build; construct; make
飞行=(of an aircraft/missile/pilot) fly
笔直=perfectly straight
宽敞=spacious; roomy; commodious
无论=no matter what/how; regardless of
试验=test; trial; experiment
简直=simply; at all
包围=surround; encircle
边界=boundary; border; borderline
争端=dispute; controversy; conflict
谈判=negotiate; negotiations
有利=advantageous; beneficial; favorable
推动=push forward; promote
条约=treaty
维护=protect; uphold; safeguard; defend
战略=strategy
伙伴=partner; companion; buddy
打击=hit; strike; attack
恐怖=terror
主义=-ism
贩毒=drug trafficking
延伸=extend; stretch; spread
和谐=harmonious; harmony
宗教=religion
利益=benefit; interest; profit
风平浪静=(wind has dropped and waves have subsided); calm and tranquil
达成=reach
一致=identical; unanimous; consistent
领土=territory; domain; land
领海=territorial waters; territorial sea
复杂=complicated; complex
虎视眈眈=(eyes covetously and menacinglyglare like a tiger ready to pounce onits prey)
稳定=stable; steady; stabilize; stability
棋子=chess piece
潜在=latent; potential
确实=true; reliable; really; indeed
任重而道远=(the burden is heavy and the road islong) difficult task (任：任务；道：路)
盟友=ally; allied nations
边境=frontier; border
红火=flourishing; prosperous
输油管=petroleum pipeline
周边=periphery
参与=participate in; have a hand in
店铺=shop; store
林立=(of tall buildings, etc.) stand (in great numbers) like a forest
管道=pipeline
倡导=initiate; propose
谈何容易=easier said than done
遗留=leave over; hand down
岛屿=Islands
成员=member
反恐=anti-terrorist
武装=armed forces; armed power
力量=power, strength,
恐怖分子=terrorist
分子=member; element; -ist
劫持=kidnap; hijack
情报=intelligence; information; tip-off
战斗机=fighter plane; fighter
起飞=(of aircraft) take off
迫降=forced landing
跑道=track; runway
装甲车=armored car
空降=airborne
直升机=helicopter
人质=hostage
押=detain in custody; escort; give as
趁=take advantage of (time, opportunity)
开枪=fire (a gun); shoot
发动=start; launch; call into action; arouse
摄像=videotape
拦=block; stop
爆炸=explode; blast
面罩=mask
作战=fight; conduct operations
特种=special; special type; particular
解救=save; rescue; deliver
激烈=intense; fierce; acute
在场=be on the scene; be present
架=for certain movable objects
架次=sortie
航次=the number of voyages or flights
客机=passenger flight
境内=within the border/boundary
摩步=motorized infantry
浓烟四起=dense smoke breaks out all over
展示=show; display
军事交通部=Military Transportation Division (MTD)
军交部=Abbreviation for MTD
军事代表处=Office of Military Representative
军代处=abbreviation for OMR
非典(萨斯病)=SARS
郑州=capital of Henan Province
松花江=a river in northeastern China
哈尔滨=capital of Heilongjiang Province
济德=name of a highway
北韩=North Korea
俄罗斯=Russia
印度=India
巴基斯坦=Pakistan
朝鲜=North Korea
苏联=Soviet Union
东南亚友好合作条约=The Treaty of ASEAN Cooperation
东盟=ASEAN
中亚=Central Asia
上海合作组织=Shanghai Cooperation Organization
越南=Vietnam
老挝=Laos
缅甸=Myanmar
尼泊尔=Nepal
蒙古=Mongolia
哈萨克斯坦=Kazakhstan
南海=South China Sea
吉 (吉尔吉斯斯坦)=Kirghizstan
塔 (塔吉克斯坦)=Tajikistan
阿雷斯坦=Alestan
