经济学=economics
美元=American dollar
金融=banking
货币=currency; monetary; money
税=tax
投资=investment
贸易=commercial trade
运营资本=working capital
债务=debt
折扣=discount
红利=bonus
出口=exit
固定收入=fixed income
自由贸易=free trade
基金=fund
接替=to replace
阵痛=labor pains
经济低迷=economic malaise
极低=very low
基于=based on
最终=final
劳务=hard labour
发布会=conference
何时=at what time
直言=to talk bluntly
缓慢=slow
债台高筑=to be mired in debt
疲软=weary, weak
低迷=to stagnate
一枝独秀=outstanding
放缓=to relax
平台=platform
财政政策=fiscal policy
外汇=foreign currency exchange
短缺=shortage
民营企业=private enterprise
500强企业=500 strongest enterprises
微观经济=microeconomic
宏观经济=macroeconomic
供销=supply and marketing
单个=single
总体=overall
指=finger
会计=accounting
博弈论=game theory
