牛肉=beef
羊肉=mutton
乞=to beg
吃=to eat
小吃=snack
采=to pick
菜=vegetable
白菜=Chinese cabbage
糸=silk
素=vegetarian
米=rice
占=to divine
点=a bit
点心=dim sum
土豆=potato
条=twig
面=face
面条=noodles
早=early
餐=meal
类=category
早餐类=breakfast dishes
擀=to roll
面=face
面条=noodles
手擀面=hand rolled noodles
炒=stir fried
饭=rice (cooked or boiled)
炒饭类=fried rice dishes
削=shaving
刀削面=knife shaved noodles
炒面类=fried noodle dishes
米=rice
粉=powder
米粉类=rice vermicelli dishes
盖=lid
盖饭类=dishes served with rice
线=line (also: thread, string)
米线类=rice noodle dishes
牛肉面=beef noodles
鸟=bird
鸡=chicken
蛋=egg
鸡蛋=chicken egg
鸡蛋面=egg noodles
榨=oppress
榨菜=hot pickled mustard tuber
丝=shredded
榨菜肉丝面=mustard pork noodles
酸=sour
酸菜肉丝面=pickled vegetables and pork noodles
红=red
烧=roasted with sauce
红烧肉丝面=red braised pork noodles
青菜=green vegetables
青菜肉丝面=green vegetable and pork noodles
牛肉炒饭=beef fried rice
扬州=Yangzhou
扬州炒饭=Yangzhou fried rice
香=fragrant
肠=intestine
香肠=sausage
酱=sauce
酱油=soy sauce
酱油炒饭=soy sauce fried rice
鸡蛋炒饭=fried rice with egg
牛肉炒刀削面=fried knife-shaved noodles with beef
鸡蛋炒刀削面=fried knife-shaved noodles with egg
肉丝炒刀削面=fried knife-shaved noodles with pork
牛肉炒面=beef fried noodles
鸡蛋炒面=egg fried noodles
肉丝炒面=fried noodles with pork
鸡蛋炒米粉=egg-fried glass noodles
盖饭=rice with pork and vegetables
青菜肉丝=pork and green vegetable stir fry
尖=sharp
椒=pepper
尖椒肉丝=chilli pepper and pork strips
尖椒土豆丝=chilli pepper and potato strips
柿=persimmon
西红柿=tomato
西红柿鸡蛋=tomato and egg stir fry
腐=rotten
豆腐=tofu
麻=hemp; numb
麻辣豆腐=numbing and spicy tofu
尖椒鸡蛋=chilli peppers and egg
辣=spicy
酸辣米线=sour and spicy rice noodles
麻辣米线=numbing and spicy rice noodles
