的=belonging (grammatical particle)
我=I (also: me)
是=to be
不=not
在=located
他=he
我们=we
有=to have
就=only then
会=to know how to
吗=question mark (used at the end of a sentence to denote a question)
要=to want
说=to speak
她=she
一=one
很=very
人=man, person
吧=bar
那=that
来=to come
都=all
能=to be able
去=to go
和=and
他们=they
到=to arrive
对=against, correct
啊=ah!
做=to do
给=to give
一个=one
上=upon
你们=you (the plural form)
真=real
事=business
怎么=how
现在=now
点=a bit
呢=a particle (a grammatical particle, not a physical one)
如果=if
只=only
别=to separate
但=but
被=by (indicates passive-voice sentences or clauses)
走=to walk
太=extremely
里=village (also: in, inside)
跟=with
因为=because
再=again
听=to listen
这里=here
快=fast
谁=who
但是=but
用气=push the air out, to use air
下=below
已经=already
你=you
天=heaven
像=to look like
它=it
从=following, from
喜欢=to like
了=to understand
大=big
需要=to need
次=measure word for actions
出=to go out
那个=that
们=plural
话=speech
而=and yet, beard (radical)
了=past tense
么=what
东西=thing
这些=these
才=only just
两=a pair
错=mistake
小=small
中=middle
好=well, good
该=should
等=to wait for
一起=together
拿=to hold
开始=to begin
帮=to help
打=to hit
爱=to love
带=to bring
时间=time
这=this
什么=what?
年=year
请=please
回=to return
工作=work
当=to work as
见=to see
想=to think
钱=money
噢=Oh!
一样=the same
事情=affair
吃=to eat
知道=to know
所有=all
个=measure word
开=to open
家=home
非常=extremely
看到=to see
希望=to wish for
没=negative
哪=which
朋友=friend
妈妈=mother
相信=to believe
也=also
还=still
前=front
嗨=oh alas
认为=to think
将=to handle, will be
这儿=here
今天=today
明白=to understand
把=to grasp
车=car
时=time
杀=to kill
呃=uhhh
发生=to happen
准备=to prepare
找到=to find
后=behind
让=to allow
过=past tense
没有=to not have
一切=everything
比=to compare
感觉=to feel
些=a few
得=must
问=to ask
离开=to leave
看=to look
起=to rise
还是=or
发现=to discover
所=which
住=to live
件=correspondence
着=action (in progress)
正=straight
而且=(not only ...) but also
必须=must
意思=interest
放=to put (also: to release)
可以=can (also: may)
肯定=to be sure
为了=in order to
这个=this
棒=brilliant, cudgel
第一=first
妈=mother
地=the earth
进=to enter
新=new
向=direction
三=three
那里=there
以为=to think (often mistakenly)
嘛=a modal particle
老=old
哦=oh
位=position
掉=to fall (also: to drop, to exchange, to turn)
先=first, previously, to precede
等等=et cetera
生活=life
之=belonging
这样=this kind
手=hand
任何=any
很多=very many; very much; great quantity
这种=this kind
女人=women
名字=name
告诉=to tell
自己=self
坐=to sit
今晚=tonight
其他=other
多=many
与=to give; with, and
或者=or
穿=to wear
弄=to do
时候=time
哪里=where
啦=a phrase-final particle
却=but
算=to calculate, to figure, to count, to plan
谢谢=thank you
继续=to continue
为什么=why?
以=using
玩=to play
亲爱=Dear or beloved (way of starting a letter)
成=to perfect
条=twig
够=enough
觉得=to feel
父亲=father
以前=before
月=moon, month
早=early
完全=complete
宝贝=treasured object
号=number
枪=gun
狗=dog
可是=but
这么=like this
小时=hour
重要=important
谈=to chat
别人=other people
男人=man
头=head
岁=years old
活=life
先生=Mr.
者=person who does
打电话=to make a telephone call
喂=hello
找=to look for
好像=as if
得到=to get
警察=police
完=end (also: finished, to run out)
最=most, superlative
张=to stretch
儿子=son
可=can
分钟=minute
接=to receive
场=open space
再见=goodbye
求=to look for
为=for the sake of
可能=possibly
如何=how
比赛=competition (sports etc)
呀=ya (to express surprise or doubt)
情况=circumstances
变=to change (to transform, to become)
真是=really
本=root
马上=at once
根本=basic
关于=concerning
是的=yes
只要=as long as
里面=inside
份=to share
每=every
到底=finally
死=to die
了解=to understand
明天=tomorrow
站=station
结束=to finish
成为=to become
永远=forever
多少=how much
名=name
它们=they
总=always
那么=so
确定=definite
有人=some person
清楚=clear
晚上=evening
怎样=how
块=lump
回家=to go home
留=to leave (something behind)
周=week
愿意=willing (to do something)
计划=to plan
爸=dad
干=dry
俩=several
停=to stop
说话=to speak
另=separately
心=heart
嘿=hey
她们=they (female)
门=gate
定=to decide
于=at, with
管=to care about
照片=photo
每个=each
敢=to dare
孩子=child
起来=to stand up (also: to revolt)
应该=ought to
兄弟=brothers
从来=always
总是=always
嘴=mouth
女儿=daughter
所以=therefore
动=to move
赢=to win
消息=news
女=woman
忙=to be busy
还有=furthermore
如此=so (like this)
队=team
拉=to pull
衣服=clothes
又=again, right hand (radical)
救=to save
睡=to sleep
唯一=only
又=again
晚=late
闭=to stop up
选择=to select / choose
原因=cause
受=to receive
连=to link (also: continuously)
好好=very well
全=complete
叫=to call
确实=indeed
挺=rather
此=this
水=water
混蛋=asshole
保证=guarantee
学校=school
卖=to sell
信=letter, mail
接受=to receive
改变=to change
舞=to dance
看来=apparently / it seems / it looks as if
高=tall
麻烦=inconvenient
出现=to appear
打算=to plan
试=to try
房间=room
美=beautiful
问题=question
不管=no matter (what, how)
特别=especially
注意=to take note of
嗯=Mmm
球=ball
忘=to forget
更=even more
甚至=even
保护=to protect
真正=genuine
结果=result
表现=to show
其实=actually
然后=after
小心=be careful
进来=to come in
呆=to stay, foolish
四=four
当时=then
就是=to be exactly
或=perhaps
只有=only
马=horse
绝对=absolute
长官=senior official
员=person
至少=at least
律师=lawyer
喔=Oh
一下=a little; a moment
那些=those
当然=of course
整个=entire
听到=to hear
表演=performance
无=to lack
已=already
笑=to laugh
也许=perhaps
选=to choose
远=to be far away
儿=son
故事=story
疯=crazy
行=okay
换=to change; to exchange
结婚=to marry
猜=to guess
咱们=we (including addressee)
床=bed
处理=to handle (process)
妻子=wife
进行=to advance
内=inside
是否=whether or not
段=paragraph
令=to command
刚刚=just recently
案子=case
行动=movement
努力=great effort
酒=wine
调查=investigation
行=profession
歌=song
成功=success
考虑=to think over
刚才=just now
节目=program
通过=to pass through
学=to study
开心=to feel happy
母亲=mother
主意=plan; idea
探=to explore
丈夫=husband
变成=to change into
离=to depart
解释=to explain
往=towards
万=ten thousand
联系=connection
派=to send
关=shut; to concern
一直=continuous
证明=proof
句=sentence
五=five
看看=to look at briefly
生命=life
有点=slightly
靠=to lean on (to lean against, to be next to)
解决=to solve
办公室=office
难道=don't tell me (...)
生=to be born
由=from
男=male
地方=place
不过=however
同意=to agree
如=if
帮忙=to help
指=finger
危险=danger
几=how much?
讨厌=to hate
曾经=once
外面=outside
处=place
看上去=it seems
几=small table
总统=president
间=space
控制=to control
最近=recently
回来=to return (come back; be back)
声音=voice
糟=pickled
爸爸=father
快乐=happy
偷=thief
首=chief
进入=entry
能够=to be able
抱歉=sorry
哈=laughter
醒=to wake up
完成=to complete
部=department
昨晚=yesterday evening
同=the same
医院=hospital
半=half
上面=top
少=few
怎么样=how about
只是=merely to be
提=to raise
斯=this
出来=to come out
要求=to request
糟糕=terrible
除了=besides
容易=easy
保持=to keep
虽然=although
办=to manage
不要=not to want
想到=to think of
教=to teach
理解=to comprehend
证据=evidence
加=to increase
脸=face
简单=simple
对不起=I'm sorry
夫人=lady
曾=once (in the past)
事实=in fact
家庭=household
象=elephant
装=outfit; to pretend
秘密=secret
法=law
一点=a bit
一定=for sure
季=season
检查=inspection
玩笑=joke
任务=mission
使=to cause
转=to revolve
博士=doctor (in the scholarly sense)
紧张=nervous
二=two
简直=simply
并=to combine
不错=not bad (pretty good)
放弃=to give up (also: to renounce)
小子=bloke
强=strength / strong
大概=approximately
的确=really
电话=telephone
特=special (also: unique, distinguished)
