平原=field
华北平原=North China plain
渤海=Bohai sea
黄海=Yellow Sea
东海=East China Sea
南海=South Sea
黄土高原=Huangtu Plateau
山东半岛=Shandong Peninsula
燕山=Yan Mountains
太行山=Taihang Mountain
中原=Central Plain
河西走廊=Hexi Corridor
四川盆地=Sichuan Basin
戈壁=desert
青藏高原=Qinghai-Tibetan plains
塔里木盆地=Tarim Basin
满洲=Manchuria
江南=South Lands
河=river
黄河=Yellow River
渭河=River Wei
川=river
盆=basin
辽河=River Liao
珠江=Pearl River
长江=Yangtze river
金沙江=Golden Sands River
峡=gorge
虎跳峡=Tiger Leaping Gorge
长江三角洲=Yangtze River delta
洛河=Luo River
汉江=Han River
乌=black, raven
乌江=Wu River
巫=witch
巫山=Mount Wu
巫山雲雨=Mount Wu (4 character Idiom)
三峡=The Three Gorges
巫峡=Wuxia Gorge, in the Changjiang River Three Gorges
大峡=Great Gorge (Wu Gorge)
瞿=startled
塘=pond
瞿塘峡=Qutang Gorge
陵=mound
西陵峡=Xiling Gorge
泰山=Mount Tai
寺=Buddhist temple
少林寺=Shaolin Monastary
少室山=Mount Shaoshi
嵩=lofty
嵩山=Songshan Mountain
鄱=name of a lake
阳=yang
湖=lake
武当山=Wudang Mountains
华山=Mount Hua
峨嵋山=Mount Emei
三皇五帝=three kings five emperors
夏=summer
朝=dynasty
夏朝=Xia Dynasty
商=to trade
商朝=Shang Dynasty
周=week
周朝=Zhou Dynasty
春=spring
秋=autumn
时=time
代=generation
时代=age
春秋时代=Spring and Autumn Period
战=war
国=kingdom
战国时代=Warring States period
州=prefecture, state
三国时代=three kingdoms period
三国演义=Romance of the Three Kingdoms
