筷子=chopsticks
叉=fork
勺=spoon
盘=plate
茶=tea
小吃=snack
水果=fruit
苹果=apple
香蕉=banana
沙拉=salad
白菜=Chinese cabbage
黄瓜=cucumber
西红柿=tomato
土豆=potato
牛肉=beef
猪肉=pork
羊肉=mutton
鸡蛋=chicken egg
蒜=garlic
味精=MSG
盐=salt
甜=honeyed
咸=salty
苦=bitter
炒=stir fried
烧烤=barbecued
醋=vinegar
酱油=soy sauce
菜单=menu
点心=dim sum
饺子=dumpling
包子=steamed stuffed bun
好吃=tasty
海鲜=seafood
羊肉串=lamb skewer
火锅=hot pot
回锅肉=twice cooked pork
水煮牛肉=boiled water beef
辣子鸡丁=chili cubed chicken
干煸牛肉=dry fried beef with chillies
麻婆豆腐=numbing spicy tofu
北京烤鸭=Peking duck
鱼香肉丝=fish fragrant shredded pork
鱼香茄子=fish fragrant aubergine
宫爆鸡丁=kung-po chicken
红烧茄子=eggplant braised in soy
素食主义=vegetarianism
啤酒=beer
买单=to order the bill
香菇=mushroom
面条=noodles
味重=strong (flavour)
可以来...=please bring... (food or dish)
片=slice
酸辣汤=hot and sour soup
刀削面=knife shaved noodles
家常豆腐=home-style tofu
干煸四季豆=dry fried beans with chili
好饱了=full (done eating)
清淡=light (of food, not greasy or strongly flavored)
四季豆=green beans
菇=mushroom
削=shaving
十=ten
木=wood, tree (radical)
酒=alcohol
蕉=banana
海=sea
煮=to boil
鸡=chicken
鸟=bird
肉=meat
鸭=duck
花=flower
重=heavy
巾=cloth
柿=persimmon
素=vegetarian
炒饭=fried rice
瓜=melon
季=season
沙=sand
淡=insipid
拉=to pull
可以=can (also: may)
婆=old woman
煸=flash fried
扁=flat
串=to string together
爆=to explode
宫=palace
茄=eggplant, aubergine
烧=roasted with sauce
酱=sauce
啤=beer
筷=chopsticks
油=oil
丝=shredded
烤=roast
心=heart
快=fast
冰=ice
了=past tense
皮=skin
腐=rotten
辣=spicy
酸=sour
锅=pot
蛋=egg
甘=sweet
条=twig
考=to be tested
内=inside
虫=bug
菜=vegetable
汤=soup
精=refined
麻=hemp; numb
羊=sheep
少=few
鲜=fresh
昔=the old days
面=face
单=single
牛=cow
水=water
每=every
允=to consent
红=red
黄=yellow
回=to return
舟=boat
交=to exchange
饺=dumpling
戊=halberd (radical)
成=to perfect
家=home
豕=swine
勿=don't
尚=to esteem
常=often
酉=alcohol flask (radical)
酒=wine
炸=fried; deep-fried
以=using
糖=sugar
乞=to beg
吃=to eat
唐=surname Tang
京=capital
共=collectively
市=market
生=to be born
饱=to be full
包=to wrap
扌=hand (squished to the side)
清=clear
由=from
猪=pig
头=head
买=to buy
者=person who does
皿=dish
西=west
而=and yet, beard (radical)
巳=fetus
钅=gold (squished to the side)
可=can
隹=dove
竹=bamboo
纟=silk (squished to the side)
鱼=fish
香=fragrant
良=good
食=food
曰=to say
禾=grain
采=to pick
辛=suffering, hot (in taste, flavor), hard, laborious
立=to stand
舌=tongue
北=north
化=to change into (also: to spend)
丬=cot (radical)
白=white
冂=glass jar (radical)
丁=nail
青=green
占=to divine
点=a bit
火=fire
灬=four dots fire (radical)
疋=bolt (of fabric)
戈=lance (also: spear)
日=sun
米=rice
味=flavour
来=to come
苹=apple
豆=bean, flask (radical)
平=to weigh
林=forest
加=to increase
果=fruit
好=well, good
四=four
古=ancient
主=lord
未=not yet
千=thousand
束=bundle
里=village (also: in, inside)
田=field
王=king
干=dry
女=woman
子=child
小=small
口=mouth
囗=surround
夕=dusk
夂=to follow
犭=small dog (radical)
广=vast, lean-to (radical)
工=work
土=earth
艹=grass (radical)
寸=chinese inch, thumb (radical)
弋=dart (also: dagger)
亻=man (squished to the side)
八=eight
勹=wrap (radical)
刀=knife
匕=ladle
氵=three dots water (radical)
冫=ice
亠=lid (radical)
卜=magic (radical)
人=man, person
一=one
丨=stick (radical)
母=female elder, mother
乍=suddenly
夬=archer's thimble
父=father
金=gold
目=eye
乙=fish hook
爫=small claws
户=door (radical)
艮=stubborn
止=to stop, toe (radical)
尸=corpse (radical)
忄=heart (squished to the side)
力=strength
儿=son
厶=cocoon (radical)
糸=silk
幺=coil (radical)
糖醋鱼=fish in sweet and sour sauce
白酒=Chinese spirits
甜食=dessert
花生米=shelled peanuts
凉拌=cold tossed (food) (also: cole slaw)
宀=roof
厂=slope
肉丝炒饭=pork fried rice
又=again, right hand (radical)
丶=drop (radical)
官=mandarin (a government official)
饣=food (squished to the side)
冖=crown (radical)
饭=rice (cooked or boiled)
反=to rebel
饭馆=restaurant
馆=hall
家常豆腐=home-style tofu
好饱了=full (done eating)
白酒=Chinese spirits
