家=home
学校=school
商店=store
中国人=Chinese person
爸爸=father
妈妈=mother
哥哥=older brother
姐姐=older sister
弟弟=younger brother
妹妹=younger sister
老师=teacher
手=hand
口=mouth
眼睛=eyes
头发=hair
耳朵=ear
鼻子=nose
个子=body height
猫=cat
狗=dog
鸟=bird
鱼=fish
水=water
牛奶=cow milk
米饭=cooked rice
面条=noodles
苹果=apple
今天=today
明天=tomorrow
现在=now
月=moon, month
号=number
星期=week
点=hour
谢谢=thank you
再见=goodbye
是=to be
有=to have
看=to look, to watch
吃=to eat
喝=to drink
去=to go
叫=be named, shout
爱=to love
喜欢=to like
认识=to know
好=well, good
多=many
大=big
小=small
长=long
高=tall
高兴=happy
我=I, me
你=you
他=he
她=she
我们=we
这=this, here
那=that, there
哪=where
谁=who
什么=what
几=how many, how much
一=one
二=two
三=three
四=four
五=five
六=six
七=seven
八=eight
九=nine
十=ten
个=measure word
岁=years old
不=no, not
很=very
和=and
在=be in, be at
的=of
吗=yes/no question word
