家=home, house, family
学校=school
商店=store
房间=room
医院=hospital
北京=Beijing
中国人=Chinese person
爸爸=father
妈妈=mother
哥哥=older brother
姐姐=older sister
弟弟=younger brother
妹妹=younger sister
老师=teacher
同学=classmate
学生=student
朋友=friend
医生=doctor
手=hand
口=mouth
眼睛=eyes
头发=hair
耳朵=ear
鼻子=nose
个子=body height
脚=foot
猫=cat
狗=dog
鸟=bird
鱼=fish
熊猫=panda
水=water
牛奶=cow milk
米饭=cooked rice
面条=noodles
苹果=apple
茶=tea
香蕉=banana
包子=steamed stuffed bun
今天=today
明天=tomorrow
现在=now
月=moon, month
号=number
星期=week
点=hour, o'clock, a bit
年=year
分钟=minute
昨天=yesterday
早上=early morning
晚上=evening
铅笔=pencil
书包=school bag
桌子=table
椅子=chair
电视=television
汉语=Chinese language
名字=name
天气=weather
颜色=colour
钱=money
里面=inside
上边=on, on top of
谢谢=thank you
再见=goodbye
请=please
不客气=You are welcome
对不起=sorry
没关系=it doesn't matter
是=am, is, are
有=to have
看=to look
吃=to eat
去=to go
叫=to call
喝=to drink
来=to come
做=to do
买=to buy
画=to paint
说话=to speak
玩=to play
学习=to learn
睡觉=to go to sleep
起床=to get up
打电话=to make a telephone call
爱=to love
喜欢=to like
认识=to know
觉得=to feel
会=can, to know how to
要=to want
可以=can (also: may)
好=well, good
大=big
小=small
长=long
高=tall
高兴=happy
冷=cold
热=heat
漂亮=pretty
好吃=tasty
红=red
黄=yellow
绿=green
我=I (also: me)
你=you
他=he
她=she
我们=we
这=this
那=that
谁=who
什么=what?
几=how (much/many)
哪=where
怎么=how
怎么样=how about
多少=how much
一=one
二=two
三=three
四=four
五=five
六=six
七=seven
七=seven
八=eight
九=nine
十=ten
两=two
零=zero
个=measure word
岁=years old
块=measure word for money, a piece of
只=measure word for small or cute animals
不=no, not
很=very
也=also
没有=to not have
真=really
和=and
在=in/at some place, present tense: doing
比=to compare
的=belonging (grammatical particle)
吗=question mark (used at the end of a sentence to denote a question)
