家=n.home
学校=n.school
商店=n.shop; store
房间=n.room
医院=n.hospital
北京=n.Beijing
车站=n.station
教室=n.classroom
动物园=n.zoo
中国人=n.Chinese
爸爸=n.father; dad
妈妈=n.mother; mum
哥哥=n.old brother
姐姐=n.old sister
老师=n.teacher
弟弟=n.young brother
妹妹=n.young sister
同学=n.classmate
学生=n.student
朋友=n.friend
医生=n.doctor
爷爷=n.grandfather
奶奶=n.grandmother
小姐=n.Miss.
先生=n.Mr.
手=n.hand
口=n.mouth
眼睛=n.eye
头发=n.hair
耳朵=n.ear
鼻子=n.nose
个子=n.height
脚=n.foot
身体=n.body
猫=n.cat
狗=n.dog
鸟=n.bird
鱼=n.fish
熊猫=n.panda
老虎=n.tiger
猴子=n.monkey
水=n.water
牛奶=n.milk
米饭=n.rice
面条=n.noodle
苹果=n.apple
茶=n.tea
香蕉=n.banana
包子=n.steamed stuffed pun
鸡蛋=n.egg
西瓜=n.watermelon
面包=n.bread
菜=n.dish
饺子=n.dumpling
果汁=n.juice
蛋糕=n.cake
水果=n.fruit
今天=n.today
明天=n.tomorrow
现在=n.now
月=n.month
号=n.date
星期=n.week
点=n.clock
年=n.year
分钟=n.minute
昨天=n.yesterday
早上=n.morning
晚上=n.evening
中午=n.noon
小时=n.hour
时候=n.time
时间=n.time
去年=n.last year
生日=n.birthday
铅笔=n.pencil
书包=n.schoolbag
桌子=n.desk
椅子=n.chair
电视=n.television
衣服=n.clothes
裙子=n.skirt
裤子=n.trousers
鞋=n.shoes
杯子=n.cup
飞机=n.airplane
公共汽车=n.bus
电脑=n.computer
电影=n.movie
玫瑰花=n.rose
礼物=n.gift
雨伞=n.umbrella
药=n.medicine
自行车=n.bicycle
汉语=n.chinese;mandarin
名字=n.name
天气=n.weather
颜色=n.color
钱=n.money
东西=n.thing
课=n.course
问题=n.question
意思=n.meaning
年级=n.grade
事情=n.matter; problem
太阳=n.sun
月亮=n.moon
里面=n.inside
上边=n.upside
前=n.front
后=n.behind
左=n.left
右=n.right
下=n.down
旁边=n.beside
外面=n.outside
谢谢=v.to thank you; to thanks
再见=v.to goodbye
请=v.to please
不客气=v.you're welcome.
对不起=v.to sorry
没关系=v.never mind.
欢迎=v.welcome
是=v.to be
有=v.to have
看=v.to see;to watch
吃=v.to eat
喝=v.to drink
去=v.to go
叫=v.to be; to call
来=v.to come
做=v.to do
坐=v.to sit
买=v.to buy
画=v.to draw
说话=v.to speak
玩=v.to play
学习=v.to study
睡觉=v.to sleep
起床=v.to get up
打电话=v.to call
听=v.to listen
读=v.to read
写=v.to write
开=v.to open
关=v.to close
回=v.to back
问=v.to ask
走=v.to walk
穿=v.to wear
洗澡=v.take a shower
给=v.to give
找=v.to find
懂=v.to understand
笑=v.to laugh
哭=v.to cry
帮助=v.to help
让=v.to let; to make
休息=v.to rest
运动=v.do sports
跑步=v.to run
游泳=v.to swim
踢足球=v.play soccer
打篮球=v.play basketball
唱歌=v.to sing
跳舞=v.to dance
完=v.to finish
生病=v.to feel sick
迟到=v.to be late
感冒=v.to have a cold
卖=v.to sell
进=v.to enter
出=v.to exit
丢=v.to throw
上网=v.to surf the Internet
拿=v.to take
刮风=v.blow wind
下雪=v.snowy
送=v.to send
爱=v.to love
喜欢=v.to like
认识=v.to know
觉得=v.to think
想=v.to think
知道=v.to know
会=v.can
要=v.have; need
可以=v.can
能=v.can
好=adj.good
多=adj.much
大=adj.big
小=adj.small
长=adj.long
高=adj.tall
高兴=adj.happy
好=adj.good
多=adj.much
大=adj.big
小=adj.small
长=adj.long
高=adj.tall
高兴=adj.happy
冷=adj.cold
热=adj.hot
漂亮=adj.beautiful
好吃=adj.delicious
红=adj.red
黄=adj.yellow
绿=adj.green
蓝=adj.blue
少=adj.few
白=adj.white
黑=adj.black
忙=adj.busy
快=adj.fast
慢=adj.slow
远=adj.far
近=adj.close
累=adj.tired
新=adj.new
对=adj.right
可爱=adj.cute
饱=adj.full
饿=adj.hungry
坏=adj.bad
舒服=adj.comfortable
着急=adj.hurry
快乐=adj.happy
难=adj.difficult
胖=adj.fat
瘦=adj.slim
男=adj.male
女=adj.female
疼=adj.hurt
我=pron.I; me
你=pron.you
他=pron.he;him
她=pron.she;her
我们=pron.we;us
这(这儿）=pron.here
那(那儿）=pron.there
哪(哪儿）=pron.where
谁=pron.who;whom
什么=pron.what
几=pron.many;much
怎么=pron.how
怎么样=pron.how is it
多少=pron.how much; how many
您=pron.you（respect）
它=pron.it
每=pron.each;every
为什么=pron.why
自己=pron.oneself
一=num.one
二=num.two
三=num.three
四=num.four
五=num.five
六=num.six
七=num.seven
八=num.eight
九=num.nine
十=num.ten
两=num.two
零=num.zero
半=num.half
百=num.hundred
千=num.thousand
第一=num.first
个=used before nouns without special measure words of their own
岁=used for age
块=piece
只=used for animals or things in pair
本=used for books of various kind
次=used for times
件=used for clothes or thing
些=used for plural things
不=adv.not; no
很=adv.very
也=adv.also
没有=adv.not; don't have
真=adv.really
都=adv.both;all
别=adv.not
一起=adv.together
太=adv.too
再=adv.again
就=adv.soon;right now
最=adv.the most
还=adv.also
当然=adv.of course
和=conj.and
因为=conj.because
所以=conj.so
但是=conj.but
在=prep.at
比=prep.than
把=prep.hold, guard, handle, grasp
的=for grammar
吗=for question
了=for grammar
呢=for question
得=for grammar
过=for grammar
吧=for mood
喂=int.for greeting
