啊=for interjection
阿姨=aunt; Mrs.
矮=short
爱=love
安静=quiet
安全=safe
八=eight
把=hold, guard, handle, grasp
爸爸=father;daddy
吧=for mood
白=white
百=hundred
搬=move
半=half
办法=way
帮助=help
包子=steamed stuffed pun
饱=full
报纸=newspaper
杯子=cup
北方=north
北京=Beijing
被=by
本=used for books of various kind
鼻子=nose
比=than
比赛=match
必须=must
毕业=graduate
变化=change
表演=perform
别=not
别人=other people
冰激凌=ice cream
冰箱=refrigerator
饼干=biscuit
不但…而且…=not only…but also…
不客气=you're welcome.
不=no;not
猜=guess
菜=dish
参观=visit
参加=join;attend
草地=grass
层=floor
茶=tea
长=long
长城=The Great Wall
尝=taste
唱歌=sing
超市=supermarket
车站=station
成绩=score
吃=eat
迟到=late
虫子=worm
出=out
出发=set out
初中=junior school
除了=except
穿=wear
窗户=window
床=bed
春季=spring
词典=dictionary
次=used for times
聪明=smart
从=from
错=wrong
打电话=call
打篮球=play basketball
打扰=bother
打扫=clean
打算=plan
打针=injection
大=big
大概=about
大海=sea
大家=everyone
大象=elephant
带=take
戴=wear
担心=be worried about
蛋糕=cake
但是=but
当然=of course
到处=everywhere
地=for grammar
的=for grammar
得=for grammar
等=wait
弟弟=young brother
地铁=subway
地图=map
地址=address
第一=first
点=clock
电灯=lamp
电脑=computer
电视=television
电梯=elevator;escalator
电影=movie
电子邮件=e-mail
丢=throw
东=east
东西=thing
冬=winter
懂=understand
动物园=zoo
都=all
读=read
肚子=belly
短=short
锻炼=exercise
对(形)=right
对(介）=for
对不起=sorry
多=much
多么=how
多少=how much;how many
饿=hungry
儿子=son
耳朵=ear
二=two
发烧=fever
方便=convenient
房间=room
放=put
放假=day off;have a holiday
非常=very
飞机=airplane
分钟=minute
服务员=waiter;waitress
附近=nearby
复习=review
干净=clean
敢=dare
感冒=have a cold
感兴趣=have an interest
刚才=just now
高=tall
高兴=happy
告诉=tell
哥哥=old brother
个=used before nouns without special measure words of their own
个子=height
给=give
更=much more
功夫=Kungfu
公共汽车=bus
公斤=kilogram
公里=kilometer
公园=park
工作=work
狗=dog
够=enough
刮风=blow wind
挂=hang
关=close
关于=about
贵=expensive
国家=country
果汁=juice
过=for grammar
哈=for laugh
还=also
还是=also
孩子=children
害怕=afaid
寒假=winter holiday
汉语=Chinese;mandarin
好=good
好吃=delicious
好像=look like
号=date
号码=number
喝=drink
和=and
合适=fit;suit
盒子=box
黑=black
很=very
红=red
猴子=monkey
后=behind
蝴蝶=butterfly
护士=nurse
互相=muture
花=flower
画=draw
坏=bad
欢迎=welcome
还=reture
换=exchange
黄=yellow
回=back
会=can
火车=train
或者=or
鸡蛋=egg
极=most
几=how much;how many
记得=remember
既…又…=…and…
加=add
家=home
坚持=insist
减=subtract
件=used for clothes or thing
健康=health
见面=meet
将来=future
讲=speak
教=teach
脚=foot
饺子=dumpling
叫=call
教室=classroom
接=catch;pick up
节目=program
节日=festival
姐姐=old sisiter
借=borrow
介绍=introduce
今天=today
紧张=nervous
进=come in
近=close
经常=often
警察=police
九=nine
旧=old
就=soon;right now
句子=sentence
觉得=think
决定=decide
开=open
开会=have a meeting
开始=begin
看=see
考试=exam
烤鸭=roast duck
渴=thirsty
可爱=cute
可能=probab
可以=can
刻=carve
课=course
空调=air-conditioner
口=mouth
哭=cry
裤子=trousers
块=piece
快=fast
快乐=happy
筷子=chopsticks
辣=spicy
来=come
来得及=be able to make it
蓝=blue
老=old
老虎=tiger
老师=teacher
了=for grammar
累=tired
冷=cold
离=from
离开=leave
梨=pear
礼貌=polite
里面=inside
礼物=gift
厉害=awsome
俩=two
联系=contact
脸=face
练习=exercise
凉快=cool
两=two
辆=for vehicle
聊天儿=chat
邻居=neighbor
零=zero
另外=besides
流汗=sweat
六=six
楼=building
旅游=travel
绿=green
妈妈=mother
马虎=careless
马上=right now
吗=for question
买=buy
卖=sell
慢=slow
忙=busy
猫=catch;pick up
没关系=you're welcome.
没有=not;don't have
玫瑰花=rose
每=each;every
妹妹=young sister
门口=doorway
迷路=lost one's way
米饭=rice
面包=bread
面条=noodle
明白=understand
明天=tomorrow
名字=name
拿=take
哪(哪儿)=where
那(那儿）=there
奶奶=grandmother
男=male
南=south
难=difficult
难过=sad
呢=for question
能=can
你=you
年=year
年级=grade
年轻=young sister
鸟=bird
您=you(respect)
牛奶=milk
努力=work hard
女=female
女儿=daughter
暖和=warm
爬山=climb the mountain
排队=queue up
排球=volleyball
盘子=plate
旁边=beside
胖=fat
跑步=run
朋友=friend
便宜=cheap
漂亮=beautiful
兵乓球=table tennis
苹果=apple
破=broken
葡萄=grape
七=seven
奇怪=weird
骑马=ride a horse
其他=other
起床=get up
起来=up
千=thousand
铅笔=pencil
前=front
钱=money
桥=bridge
巧克力=chocolate
清楚=clear
晴=sunny
请=please
秋=autumn
去=go
去年=last year
裙子=skirt
然后=then
让=let;make
热=hot
认识=know
认真=serious
容易=easy
如果…那么…=if…then…
三=three
散步=walk
沙发=sofa
商店=shop;store
上班=go to work
上边=above
上海=Shanghai
上网=surf the Internet
少=few;little
谁=who;whom
身体=body
什么=what
生病=feel sick
生活=live
生气=angry
生日=birthday
声音=sound
十=ten
时候=time
时间=time
是=to be
事情=matter;problem
手=hand
手表=watch
瘦=slim
受不了=can't stand
售票员=ticket seller
书包=schoolbag
舒服=comfortable
叔叔=uncle
熟悉=familiar
暑假=summer holiday
刷牙=brush teeth
双=double
水=water
水果=fruit
睡觉=sleep
说话=speak
四=four
送=send
虽然=though
岁=year
孙子=grandson
所以=so
他=he;him
她=she;her
它=it
太=too
太阳=sun
弹钢琴=play the piano
汤=soup
糖=sugar
躺=lie
桃=peach
讨论=discuss
讨厌=hate
特别=special
疼=hurt
踢足球=play soccer
体育馆=gymnasium
天气=weather
甜=sweat
条=used for long,thin,narrow things
跳舞=dance
听=listen
听说=it's said
停=stop
同学=classmate
同意=agree
头发=hair
突然=sudden
图书馆=library
兔子=rabbit
腿=leg
脱=take off
外面=outside
完=finish
玩=play
玩具=toy
晚上=evening
万=Measure word for number
网球=tennis
忘记=forget
危险=dangerous
喂=for greeting
为了=for
为什么=why
问=ask
问题=question
我=I;me
我们=we;us
无论=no matter
五=five
西=west
西瓜=watermelon
西红柿=tomato
希望=hope
习惯=used to
喜欢=like
洗手间=toilet
洗澡=take a shower
下=down
下雪=snowy
夏=summer
先=first
先生=Mr.
现在=now
香蕉=banana
响=loud
想=think
向=toward
小=small
小姐=Miss.
小时=hour
小心=careful
笑=smile
校园=campus
些=some
鞋=shoes
写=write
谢谢=thank you;thanks
新=new
新闻=news
心情=mood
信封=envelope
星期=week
星星=star
行=ok
醒=wake
幸福=happiness
熊猫=panda
休息=rest
选择=choose
学生=student
学习=study
学校=school
颜色=color
眼镜=glasses
眼睛=eyes
羊肉=mutton
药=medicine
要=want;need
钥匙=key
爷爷=grandpa
也=also
页=page
一=one
衣服=clothes
医生=doctor
医院=hospital
一定=must
一共=totally
一会儿=for a while
一下儿=for a while
一样=same
已经=already
以前=before
以为=think
椅子=chair
一边…一边…=doing A and B the same time
一点儿=a little
一起=together
意思=meaning
一直=all the time
因为=because
饮料=drink
应该=should
勇敢=brave
用=use
游戏=game
游泳=swim
有=have
有名=famous
右=right
鱼=fish
雨伞=umbrella
元=Measure word for money
圆=round
远=far
月=moon
月亮=moon
越来越=more and more
云=cloud
运动=sport
杂志=magazine
在=at;in
再=again
再见=goodbye
早上=morning
怎么=how
怎么样=how is it
站=stand
张=used for things with a surface
着急=hurry
找=find;search
照顾=look after
照片=picture
照相=take photos
这(这儿)=here
着=for grammar
真=really
正在=be doing
只=only
知道=understand
知识=knowledge
只要=as long as
中国人=Chinese
中间=middle
中午=noon
种=kind
重要=important
周末=weekend
住=live
祝贺=congratulation
注意=attention
准备=prepare
准时=on time
桌子=table
自己=oneself
自行车=bicycle
走=walk
最=most
最近=recently
昨天=yesterday
左=left
坐=sit
做=do
作业=assignment
